//MAP CONVERTED BY dmm2tgm.py THIS HEADER COMMENT PREVENTS RECONVERSION, DO NOT REMOVE
"a" = (
/turf/open/floor/rogue/cobblerock,
/area/rogue/under/tomb)
"d" = (
/obj/machinery/light/rogue/wallfire/candle/l,
/turf/open/floor/rogue/cobblerock,
/area/rogue/under/tomb)
"m" = (
/obj/machinery/light/rogue/wallfire/candle/blue/l,
/turf/open/floor/rogue/cobblerock,
/area/rogue/under/tomb)
"n" = (
/turf/closed/wall/mineral/rogue/stone/moss,
/area/rogue/under/tomb)
"v" = (
/obj/machinery/light/rogue/wallfire/candle/r,
/turf/open/floor/rogue/cobblerock,
/area/rogue/under/tomb)
"w" = (
/obj/machinery/light/rogue/wallfire/candle/blue/r,
/turf/open/floor/rogue/cobblerock,
/area/rogue/under/tomb)
"M" = (
/obj/structure/ladder,
/turf/open/floor/rogue/cobblerock,
/area/rogue/under/tomb)
"S" = (
/turf/closed/mineral/rogue/bedrock,
/area/rogue/under/tomb)

(1,1,1) = {"
S
S
a
S
S
"}
(2,1,1) = {"
S
m
a
m
S
"}
(3,1,1) = {"
a
a
M
a
a
"}
(4,1,1) = {"
S
w
a
w
S
"}
(5,1,1) = {"
S
S
a
S
S
"}

(1,1,2) = {"
n
n
a
n
n
"}
(2,1,2) = {"
n
d
a
d
n
"}
(3,1,2) = {"
a
a
M
a
a
"}
(4,1,2) = {"
n
v
a
v
n
"}
(5,1,2) = {"
n
n
a
n
n
"}
