//MAP CONVERTED BY dmm2tgm.py THIS HEADER COMMENT PREVENTS RECONVERSION, DO NOT REMOVE
"a" = (
/obj/structure/flora/newtree,
/turf/open/floor/rogue/dirt,
/area/rouge/under/tomb/wilds/ambush)
"c" = (
/obj/effect/spawner/roguemap/treeorbush,
/obj/structure/flora/tree/wise{
	desc = "You must be exactlyh 25 years old to play this game.";
	name = "Woody"
	},
/turf/open/floor/rogue/dirt,
/area/rouge/under/tomb/wilds/ambush)
"h" = (
/turf/closed/mineral/rogue/bedrock,
/area/rouge/under/tomb/wilds)
"m" = (
/obj/effect/landmark/ambush,
/turf/open/floor/rogue/dirt/road,
/area/rouge/under/tomb/wilds/ambush)
"q" = (
/obj/structure/flora/newtree,
/turf/open/floor/rogue/dirt/ambush,
/area/rouge/under/tomb/wilds/ambush)
"w" = (
/obj/effect/spawner/roguemap/treeorbush,
/obj/structure/flora/tree/evil,
/turf/open/floor/rogue/dirt,
/area/rouge/under/tomb/wilds/ambush)
"y" = (
/obj/effect/spawner/roguemap/treeorbush,
/obj/effect/spawner/roguemap/treeorbush,
/turf/open/floor/rogue/dirt,
/area/rouge/under/tomb/wilds/ambush)
"C" = (
/turf/open/floor/rogue/dirt/road,
/area/rouge/under/tomb/wilds/ambush)
"E" = (
/turf/closed/mineral/rogue/bedrock,
/area/rouge/under/tomb/wilds/ambush)
"F" = (
/obj/effect/spawner/roguemap/treeorbush,
/turf/open/floor/rogue/dirt,
/area/rouge/under/tomb/wilds/ambush)
"I" = (
/turf/open/transparent/openspace,
/area/rouge/under/tomb/wilds)
"K" = (
/obj/effect/spawner/roguemap/treeorbush,
/turf/open/floor/rogue/dirt/ambush,
/area/rouge/under/tomb/wilds/ambush)
"L" = (
/turf/open/floor/rogue/naturalstone,
/area/rouge/under/tomb/wilds)
"M" = (
/obj/effect/dungeon_directional_helper/west,
/turf/open/floor/rogue/dirt/road,
/area/rouge/under/tomb/wilds/ambush)
"V" = (
/obj/effect/dungeon_directional_helper/east,
/turf/open/floor/rogue/dirt/road,
/area/rouge/under/tomb/wilds/ambush)
"Y" = (
/turf/open/floor/rogue/dirt/ambush,
/area/rouge/under/tomb/wilds/ambush)

(1,1,1) = {"
E
C
C
M
C
C
C
E
"}
(2,1,1) = {"
E
F
F
a
F
a
C
E
"}
(3,1,1) = {"
E
F
F
F
F
K
C
E
"}
(4,1,1) = {"
E
F
C
C
Y
C
C
E
"}
(5,1,1) = {"
E
F
m
a
F
a
F
E
"}
(6,1,1) = {"
E
c
C
Y
F
F
F
E
"}
(7,1,1) = {"
E
a
C
C
C
C
F
E
"}
(8,1,1) = {"
E
F
F
F
a
m
F
E
"}
(9,1,1) = {"
E
C
C
C
C
C
F
E
"}
(10,1,1) = {"
E
C
y
y
F
q
F
E
"}
(11,1,1) = {"
E
m
a
F
C
C
C
E
"}
(12,1,1) = {"
E
C
C
C
C
a
C
E
"}
(13,1,1) = {"
E
F
F
F
F
w
C
E
"}
(14,1,1) = {"
E
F
a
F
F
F
C
E
"}
(15,1,1) = {"
E
C
C
V
C
C
C
E
"}

(1,1,2) = {"
h
L
L
L
L
L
L
h
"}
(2,1,2) = {"
h
I
I
I
I
I
I
h
"}
(3,1,2) = {"
h
I
I
I
I
I
I
h
"}
(4,1,2) = {"
h
I
I
I
I
I
I
h
"}
(5,1,2) = {"
h
I
I
I
I
I
I
h
"}
(6,1,2) = {"
h
I
I
I
I
I
I
h
"}
(7,1,2) = {"
h
I
I
I
I
I
I
h
"}
(8,1,2) = {"
h
I
I
I
I
I
I
h
"}
(9,1,2) = {"
h
I
I
I
I
I
I
h
"}
(10,1,2) = {"
h
I
I
I
I
I
I
h
"}
(11,1,2) = {"
h
I
I
I
I
I
I
h
"}
(12,1,2) = {"
h
I
I
I
I
I
I
h
"}
(13,1,2) = {"
h
I
I
I
I
I
I
h
"}
(14,1,2) = {"
h
I
I
I
I
I
I
h
"}
(15,1,2) = {"
h
L
L
L
L
L
L
h
"}
