//MAP CONVERTED BY dmm2tgm.py THIS HEADER COMMENT PREVENTS RECONVERSION, DO NOT REMOVE
"a" = (
/turf/closed/mineral/rogue/bedrock,
/area/rogue/under/tomb/cave)
"b" = (
/obj/item/reagent_containers/glass/bottle/rogue/beer/avarmead,
/obj/item/reagent_containers/glass/bottle/rogue/beer/avarmead,
/turf/open/floor/rogue/naturalstone,
/area/rogue/under/tomb/indoors)
"d" = (
/obj/item/natural/poo,
/turf/open/floor/rogue/naturalstone,
/area/rogue/under/tomb)
"e" = (
/turf/closed/mineral/rogue/bedrock,
/area/rogue/under/tomb/indoors)
"i" = (
/obj/structure/bed/rogue/shit,
/mob/living/carbon/human/species/npc/deadite,
/turf/open/floor/rogue/naturalstone,
/area/rogue/under/tomb/indoors)
"l" = (
/obj/structure/roguetent,
/turf/open/floor/rogue/naturalstone,
/area/rogue/under/tomb/indoors)
"n" = (
/obj/item/roguecoin/silver,
/turf/open/floor/rogue/naturalstone,
/area/rogue/under/tomb)
"q" = (
/turf/open/floor/rogue/naturalstone,
/area/rogue/under/tomb/indoors)
"z" = (
/turf/open/transparent/openspace,
/area/rogue/under/tomb)
"D" = (
/obj/effect/decal/cleanable/vomit/old,
/turf/open/floor/rogue/naturalstone,
/area/rogue/under/tomb/indoors)
"H" = (
/turf/open/floor/rogue/naturalstone,
/area/rogue/under/tomb)
"J" = (
/obj/item/reagent_containers/glass/bottle/rogue/beer/avarrice,
/turf/open/floor/rogue/naturalstone,
/area/rogue/under/tomb/indoors)
"K" = (
/obj/structure/toilet,
/obj/structure/flora/roguegrass/maneater/real{
	pixel_y = 9
	},
/obj/item/roguecoin/silver{
	pixel_y = -2
	},
/turf/open/floor/rogue/naturalstone,
/area/rogue/under/tomb)
"Q" = (
/turf/open/floor/rogue/naturalstone,
/area/rogue/under/tomb/cave)
"U" = (
/obj/item/paper{
	pixel_y = 19
	},
/obj/item/paper{
	pixel_y = 4;
	pixel_x = 8
	},
/obj/item/paper{
	pixel_y = -4;
	pixel_x = -4
	},
/turf/open/floor/rogue/naturalstone,
/area/rogue/under/tomb)

(1,1,1) = {"
a
a
a
a
a
a
a
H
H
H
H
H
a
a
a
a
a
a
a
a
"}
(2,1,1) = {"
a
a
a
a
a
a
a
H
H
H
H
H
a
a
a
a
a
a
a
a
"}
(3,1,1) = {"
a
a
a
a
a
a
a
H
H
H
H
H
a
Q
a
a
a
a
a
a
"}
(4,1,1) = {"
a
a
a
Q
Q
a
H
H
H
H
H
H
H
H
a
a
a
Q
a
a
"}
(5,1,1) = {"
a
a
a
Q
Q
H
H
H
H
H
H
H
H
H
H
H
Q
Q
a
a
"}
(6,1,1) = {"
a
a
a
Q
Q
H
H
H
H
H
H
H
H
H
H
H
a
Q
a
a
"}
(7,1,1) = {"
a
a
a
a
H
H
H
H
H
H
H
H
H
H
H
H
H
Q
a
a
"}
(8,1,1) = {"
H
H
H
H
H
H
H
H
H
H
H
H
H
H
H
H
H
H
H
H
"}
(9,1,1) = {"
H
H
H
H
H
H
H
H
H
n
n
H
H
H
H
H
H
H
H
H
"}
(10,1,1) = {"
H
H
H
H
H
H
H
H
H
n
K
n
H
H
H
H
H
H
H
H
"}
(11,1,1) = {"
H
H
H
H
H
H
H
H
H
n
U
n
H
H
H
H
H
H
H
H
"}
(12,1,1) = {"
H
H
H
H
H
H
H
H
H
H
H
H
H
H
H
H
H
H
H
H
"}
(13,1,1) = {"
a
a
a
a
Q
H
H
H
H
H
H
H
H
H
a
Q
Q
a
a
a
"}
(14,1,1) = {"
a
a
a
Q
Q
Q
a
H
H
H
H
H
H
H
Q
Q
Q
a
a
a
"}
(15,1,1) = {"
a
a
a
Q
Q
Q
Q
a
H
H
H
H
a
a
a
Q
Q
a
a
a
"}
(16,1,1) = {"
a
a
a
a
Q
Q
Q
Q
H
H
H
H
Q
Q
a
Q
Q
a
a
a
"}
(17,1,1) = {"
a
a
a
a
Q
Q
Q
Q
H
H
H
H
a
Q
Q
Q
Q
a
a
a
"}
(18,1,1) = {"
a
a
a
a
a
a
a
a
H
H
H
H
Q
Q
Q
a
a
a
a
a
"}
(19,1,1) = {"
a
a
a
a
a
a
a
a
H
H
H
H
a
a
a
a
a
a
a
a
"}
(20,1,1) = {"
a
a
a
a
a
a
a
a
H
H
H
H
a
a
a
a
a
a
a
a
"}

(1,1,2) = {"
e
e
e
e
e
e
e
a
H
H
H
a
a
a
a
a
a
a
a
a
"}
(2,1,2) = {"
e
J
b
D
q
q
e
a
H
H
H
a
a
a
a
a
a
a
a
a
"}
(3,1,2) = {"
e
J
b
q
D
q
e
H
H
H
H
H
a
Q
Q
Q
Q
a
a
a
"}
(4,1,2) = {"
e
i
q
q
q
q
e
H
H
H
H
H
a
Q
Q
a
a
Q
a
a
"}
(5,1,2) = {"
e
e
e
e
e
l
e
H
H
H
H
H
Q
Q
Q
a
a
Q
a
a
"}
(6,1,2) = {"
a
a
Q
Q
Q
Q
a
H
H
H
H
H
a
a
a
a
a
Q
a
a
"}
(7,1,2) = {"
a
a
Q
a
a
a
a
H
H
H
H
H
H
H
a
Q
a
Q
Q
a
"}
(8,1,2) = {"
a
H
H
H
H
H
H
H
H
H
H
H
H
H
H
H
H
Q
a
a
"}
(9,1,2) = {"
H
H
H
H
H
H
H
H
H
H
n
H
H
H
H
H
H
H
a
H
"}
(10,1,2) = {"
H
H
a
H
H
H
H
H
H
n
z
H
H
H
H
H
H
H
H
H
"}
(11,1,2) = {"
H
a
a
H
H
H
H
H
H
H
d
H
H
H
H
H
H
H
H
H
"}
(12,1,2) = {"
a
a
Q
Q
H
H
H
H
H
H
H
H
H
H
H
H
H
H
a
a
"}
(13,1,2) = {"
a
a
a
Q
a
a
a
H
H
H
H
H
a
Q
a
a
a
a
Q
a
"}
(14,1,2) = {"
a
a
a
Q
a
a
a
H
H
H
H
H
a
Q
Q
a
Q
Q
Q
a
"}
(15,1,2) = {"
a
Q
Q
Q
Q
Q
a
H
H
H
H
H
a
a
Q
a
Q
Q
a
a
"}
(16,1,2) = {"
a
Q
a
Q
Q
Q
Q
H
H
H
H
H
a
a
Q
Q
a
a
a
a
"}
(17,1,2) = {"
a
Q
a
a
Q
a
a
H
H
H
H
H
a
Q
Q
Q
a
a
a
a
"}
(18,1,2) = {"
a
Q
Q
a
Q
Q
Q
H
H
H
H
H
a
a
Q
a
a
a
a
a
"}
(19,1,2) = {"
a
a
Q
a
a
a
Q
a
a
H
H
a
Q
Q
Q
a
a
a
a
a
"}
(20,1,2) = {"
a
a
a
a
a
a
a
a
H
H
H
a
a
a
a
a
a
a
a
a
"}
