//MAP CONVERTED BY dmm2tgm.py THIS HEADER COMMENT PREVENTS RECONVERSION, DO NOT REMOVE
"a" = (
/turf/closed/mineral/rogue/bedrock,
/area/rogue/under/tomb/cave/lava)
"e" = (
/obj/effect/dungeon_directional_helper/north,
/turf/open/floor/rogue/naturalstone,
/area/rogue/under/tomb/cave/lava)
"g" = (
/obj/item/natural/rock/coal,
/turf/open/floor/rogue/volcanic,
/area/rogue/under/tomb/cave/lava)
"h" = (
/obj/structure/flora/rock,
/turf/open/floor/rogue/naturalstone,
/area/rogue/under/tomb/cave/lava)
"m" = (
/obj/item/natural/rock/coal,
/turf/open/floor/rogue/naturalstone,
/area/rogue/under/tomb/cave/lava)
"p" = (
/turf/open/floor/rogue/volcanic,
/area/rogue/under/tomb/cave/lava)
"r" = (
/obj/item/natural/rock/gem,
/turf/open/floor/rogue/volcanic,
/area/rogue/under/tomb/cave/lava)
"x" = (
/turf/open/floor/rogue/naturalstone,
/area/rogue/under/tomb/cave/lava)
"z" = (
/obj/structure/flora/rock/pile,
/turf/open/floor/rogue/naturalstone,
/area/rogue/under/tomb/cave/lava)
"D" = (
/obj/item/natural/rock/random_ore,
/turf/open/floor/rogue/volcanic,
/area/rogue/under/tomb/cave/lava)
"F" = (
/obj/effect/dungeon_directional_helper/west,
/turf/open/floor/rogue/naturalstone,
/area/rogue/under/tomb/cave/lava)
"G" = (
/obj/item/natural/rock/random_ore,
/turf/open/floor/rogue/naturalstone,
/area/rogue/under/tomb/cave/lava)
"H" = (
/turf/open/transparent/openspace,
/area/rogue/under/tomb/cave/lava)
"O" = (
/mob/living/carbon/human/species/goblin/npc/ambush/cave,
/turf/open/floor/rogue/naturalstone,
/area/rogue/under/tomb/cave/lava)
"S" = (
/obj/effect/dungeon_directional_helper/east,
/turf/open/floor/rogue/naturalstone,
/area/rogue/under/tomb/cave/lava)
"U" = (
/turf/open/lava,
/area/rogue/under/tomb/cave/lava)
"W" = (
/obj/structure/stairs/stone{
	dir = 1
	},
/turf/open/floor/rogue/naturalstone,
/area/rogue/under/tomb/cave/lava)
"X" = (
/obj/effect/dungeon_directional_helper/south,
/turf/open/floor/rogue/naturalstone,
/area/rogue/under/tomb/cave/lava)

(1,1,1) = {"
a
a
a
x
F
m
a
a
a
a
"}
(2,1,1) = {"
a
a
U
p
x
x
U
a
a
a
"}
(3,1,1) = {"
a
a
U
p
x
p
a
a
U
a
"}
(4,1,1) = {"
a
U
U
g
x
x
a
U
U
a
"}
(5,1,1) = {"
D
D
x
p
x
x
O
p
D
G
"}
(6,1,1) = {"
e
x
x
a
a
W
x
x
x
X
"}
(7,1,1) = {"
x
x
r
U
a
W
x
x
x
x
"}
(8,1,1) = {"
a
a
p
r
O
x
x
p
x
a
"}
(9,1,1) = {"
a
a
a
x
x
x
D
D
a
a
"}
(10,1,1) = {"
a
a
a
a
S
x
D
a
a
a
"}

(1,1,2) = {"
a
a
a
a
x
x
x
a
a
a
"}
(2,1,2) = {"
a
a
a
z
x
x
G
G
a
a
"}
(3,1,2) = {"
a
a
a
a
x
x
a
a
a
a
"}
(4,1,2) = {"
x
G
a
a
x
x
x
a
G
a
"}
(5,1,2) = {"
x
G
G
x
x
a
x
x
x
G
"}
(6,1,2) = {"
x
x
x
O
W
H
a
x
x
x
"}
(7,1,2) = {"
a
x
x
x
W
H
a
a
x
x
"}
(8,1,2) = {"
a
a
h
x
a
a
a
h
x
a
"}
(9,1,2) = {"
a
a
x
x
G
x
a
a
a
a
"}
(10,1,2) = {"
a
a
a
x
x
G
a
a
a
a
"}
