//MAP CONVERTED BY dmm2tgm.py THIS HEADER COMMENT PREVENTS RECONVERSION, DO NOT REMOVE
"a" = (
/turf/closed/mineral/rogue/bedrock,
/area/rogue/under/tomb/cave/lava)
"d" = (
/turf/open/floor/rogue/naturalstone,
/area/rogue/under/tomb/cave/lava)
"k" = (
/mob/living/carbon/human/species/goblin/npc/ambush/cave,
/turf/open/floor/rogue/volcanic,
/area/rogue/under/tomb/cave/lava)
"n" = (
/mob/living/carbon/human/species/goblin/npc/ambush/cave,
/turf/open/floor/rogue/naturalstone,
/area/rogue/under/tomb/cave/lava)
"o" = (
/turf/open/floor/rogue/volcanic,
/area/rogue/under/tomb/cave/lava)
"t" = (
/obj/item/natural/rock/random_ore,
/turf/open/floor/rogue/volcanic,
/area/rogue/under/tomb/cave/lava)
"A" = (
/obj/effect/dungeon_directional_helper/south,
/turf/open/floor/rogue/naturalstone,
/area/rogue/under/tomb/cave/lava)
"B" = (
/obj/effect/dungeon_directional_helper/east,
/turf/open/floor/rogue/volcanic,
/area/rogue/under/tomb/cave/lava)
"I" = (
/mob/living/carbon/human/species/goblin/npc/ambush/cave,
/obj/item/natural/rock/random_ore,
/turf/open/floor/rogue/naturalstone,
/area/rogue/under/tomb/cave/lava)
"M" = (
/obj/structure/stairs/stone{
	dir = 8
	},
/turf/open/floor/rogue/naturalstone,
/area/rogue/under/tomb/cave/lava)
"Q" = (
/obj/effect/dungeon_directional_helper/west,
/turf/open/floor/rogue/naturalstone,
/area/rogue/under/tomb/cave/lava)
"S" = (
/obj/item/natural/rock/gem,
/turf/open/floor/rogue/volcanic,
/area/rogue/under/tomb/cave/lava)
"U" = (
/obj/effect/dungeon_directional_helper/north,
/turf/open/floor/rogue/volcanic,
/area/rogue/under/tomb/cave/lava)
"W" = (
/turf/open/transparent/openspace,
/area/rogue/under/tomb/cave/lava)
"X" = (
/obj/item/natural/rock/random_ore,
/turf/open/floor/rogue/naturalstone,
/area/rogue/under/tomb/cave/lava)
"Y" = (
/turf/open/lava,
/area/rogue/under/tomb/cave/lava)

(1,1,1) = {"
a
a
a
a
a
a
o
Q
d
o
a
a
a
a
a
"}
(2,1,1) = {"
a
a
a
a
a
o
o
d
o
o
o
a
a
Y
a
"}
(3,1,1) = {"
a
a
a
a
d
d
d
o
o
d
d
d
Y
Y
a
"}
(4,1,1) = {"
a
a
a
Y
t
a
a
o
o
a
X
t
o
a
a
"}
(5,1,1) = {"
a
a
Y
Y
t
t
o
o
a
a
a
d
d
a
a
"}
(6,1,1) = {"
a
a
a
Y
d
o
o
a
a
a
a
a
X
o
a
"}
(7,1,1) = {"
d
d
o
d
d
d
k
a
M
M
a
a
o
o
o
"}
(8,1,1) = {"
U
d
d
o
o
o
o
X
n
o
o
d
o
d
A
"}
(9,1,1) = {"
o
o
o
o
d
d
o
d
d
d
d
o
o
d
d
"}
(10,1,1) = {"
o
o
t
a
Y
d
o
k
d
t
o
t
Y
Y
a
"}
(11,1,1) = {"
a
X
a
a
o
o
o
d
o
t
a
Y
Y
a
a
"}
(12,1,1) = {"
a
X
d
o
t
o
d
a
d
o
a
a
a
a
a
"}
(13,1,1) = {"
a
a
Y
Y
a
X
d
o
o
d
a
a
a
a
a
"}
(14,1,1) = {"
a
a
Y
a
a
Y
o
d
d
d
Y
a
a
a
a
"}
(15,1,1) = {"
a
a
a
a
a
a
o
B
o
a
a
a
a
a
a
"}

(1,1,2) = {"
a
a
a
a
a
a
o
o
d
a
a
a
a
a
a
"}
(2,1,2) = {"
a
a
a
a
a
t
t
d
d
d
a
a
a
W
a
"}
(3,1,2) = {"
a
a
a
a
o
o
t
d
d
o
a
a
W
W
a
"}
(4,1,2) = {"
a
a
a
W
t
a
a
d
d
o
o
S
S
a
a
"}
(5,1,2) = {"
a
a
W
W
d
o
d
d
d
o
o
o
a
a
a
"}
(6,1,2) = {"
a
a
a
W
d
o
o
n
M
M
o
d
a
a
a
"}
(7,1,2) = {"
d
X
X
d
d
d
o
a
W
W
d
d
d
d
o
"}
(8,1,2) = {"
d
d
d
d
d
o
o
a
a
a
a
d
d
o
o
"}
(9,1,2) = {"
o
d
o
o
o
o
o
o
a
a
a
a
o
o
o
"}
(10,1,2) = {"
t
o
S
a
W
d
d
o
I
a
a
a
W
W
a
"}
(11,1,2) = {"
a
o
a
a
d
o
o
d
a
a
a
W
W
X
a
"}
(12,1,2) = {"
a
t
o
d
d
a
o
o
a
a
a
X
X
a
a
"}
(13,1,2) = {"
a
a
W
W
a
a
t
t
o
o
d
d
a
a
a
"}
(14,1,2) = {"
a
a
W
a
a
a
d
o
o
d
W
a
a
a
a
"}
(15,1,2) = {"
a
a
a
a
a
a
d
o
d
a
a
a
a
a
a
"}
