//MAP CONVERTED BY dmm2tgm.py THIS HEADER COMMENT PREVENTS RECONVERSION, DO NOT REMOVE
"an" = (
/obj/structure/flora/roguetree/burnt,
/turf/open/floor/rogue/dirt,
/area/rogue/under/tomb/cave/lava)
"bA" = (
/obj/structure/noose/gallows,
/turf/open/floor/rogue/ruinedwood/spiral,
/area/rogue/under/tomb/cave/lava)
"bJ" = (
/obj/machinery/light/rogue/campfire/densefire,
/turf/open/floor/rogue/naturalstone,
/area/rogue/under/tomb/cave/lava)
"da" = (
/obj/effect/dungeon_directional_helper/north,
/turf/open/floor/rogue/cobblerock,
/area/rogue/under/tomb/cave/lava)
"dk" = (
/turf/closed/wall/mineral/rogue/tent,
/area/rogue/under/tomb/indoors)
"dv" = (
/obj/effect/dungeon_directional_helper/east,
/turf/open/floor/rogue/dirt/road,
/area/rogue/under/tomb/cave/lava)
"dY" = (
/obj/structure/fluff/railing/border{
	dir = 4
	},
/turf/open/lava/acid,
/area/rogue/under/tomb/cave/lava)
"eK" = (
/turf/open/floor/rogue/cobblerock,
/area/rogue/under/tomb/cave/lava)
"fK" = (
/obj/structure/flora/roguetree/burnt,
/turf/open/transparent/openspace,
/area/rogue/under/tomb/cave/lava)
"hC" = (
/obj/structure/fluff/railing/border{
	dir = 8
	},
/turf/open/lava/acid,
/area/rogue/under/tomb/cave/lava)
"hE" = (
/turf/open/floor/rogue/dirt,
/area/rogue/under/tomb/indoors)
"hK" = (
/obj/machinery/light/rogue/campfire,
/turf/open/floor/rogue/naturalstone,
/area/rogue/under/tomb/indoors)
"ih" = (
/obj/structure/fluff/railing/border{
	dir = 1
	},
/turf/open/floor/rogue/naturalstone,
/area/rogue/under/tomb/cave/lava)
"it" = (
/obj/structure/closet/crate/chest/neu,
/obj/item/bedroll,
/obj/item/bedroll,
/obj/effect/spawner/lootdrop/roguetown/dungeon/food,
/obj/effect/spawner/lootdrop/roguetown/dungeon/food,
/turf/open/floor/rogue/naturalstone,
/area/rogue/under/tomb/cave/lava)
"jt" = (
/obj/structure/roguetent,
/turf/open/floor/rogue/cobblerock,
/area/rogue/under/tomb/indoors)
"jA" = (
/obj/structure/fluff/railing/border{
	dir = 10
	},
/turf/open/floor/rogue/dirt,
/area/rogue/under/tomb/cave/lava)
"jJ" = (
/turf/open/water/swamp/deep,
/area/rogue/under/tomb/cave/lava)
"jL" = (
/obj/structure/bed/rogue/shit,
/turf/open/floor/rogue/dirt,
/area/rogue/under/tomb/indoors)
"jO" = (
/turf/open/floor/rogue/naturalstone,
/area/rogue/under/tomb/cave/lava)
"kG" = (
/obj/structure/fluff/railing/border{
	dir = 5
	},
/turf/open/floor/rogue/naturalstone,
/area/rogue/under/tomb/cave/lava)
"lt" = (
/obj/structure/fluff/railing/border,
/turf/open/floor/rogue/naturalstone,
/area/rogue/under/tomb/cave/lava)
"lE" = (
/turf/open/floor/rogue/cobblerock,
/area/rogue/under/tomb/indoors)
"me" = (
/turf/open/floor/rogue/metal,
/area/rogue/under/tomb/cave/lava)
"mV" = (
/obj/structure/fluff/railing/border{
	dir = 6
	},
/turf/open/floor/rogue/naturalstone,
/area/rogue/under/tomb/cave/lava)
"nm" = (
/mob/living/simple_animal/hostile/retaliate/rogue/bigrat,
/turf/open/floor/rogue/cobblerock,
/area/rogue/under/tomb/cave/lava)
"np" = (
/obj/structure/closet/crate/chest/wicker,
/obj/effect/spawner/lootdrop/roguetown/dungeon/misc,
/obj/effect/spawner/lootdrop/roguetown/dungeon/misc,
/turf/open/floor/rogue/dirt,
/area/rogue/under/tomb/indoors)
"nJ" = (
/obj/structure/table/church/m,
/obj/item/clothing/neck/roguetown/psicross/ravox,
/turf/open/floor/rogue/churchmarble,
/area/rogue/under/tomb/cave/lava)
"nR" = (
/obj/structure/fluff/railing/border{
	dir = 5
	},
/obj/structure/fluff/railing/border{
	dir = 9
	},
/obj/structure/stairs{
	dir = 1
	},
/turf/open/floor/rogue/cobblerock,
/area/rogue/under/tomb/cave/lava)
"oW" = (
/turf/closed/wall/mineral/rogue/stone/window,
/area/rogue/under/tomb/cave/lava)
"pO" = (
/turf/open/floor/rogue/churchmarble,
/area/rogue/under/tomb/cave/lava)
"qe" = (
/obj/structure/table/church{
	icon_state = "churchtable_end"
	},
/turf/open/floor/rogue/churchmarble,
/area/rogue/under/tomb/cave/lava)
"qx" = (
/obj/structure/table/church,
/obj/effect/spawner/lootdrop/roguetown/dungeon/weapons,
/turf/open/floor/rogue/churchmarble,
/area/rogue/under/tomb/cave/lava)
"qX" = (
/obj/machinery/light/rogue/firebowl/stump,
/turf/open/floor/rogue/dirt/road,
/area/rogue/under/tomb/cave/lava)
"qZ" = (
/obj/structure/fluff/railing/border{
	dir = 9
	},
/turf/open/floor/rogue/naturalstone,
/area/rogue/under/tomb/cave/lava)
"rA" = (
/obj/effect/spawner/lootdrop/roguetown/dungeon/weapons,
/turf/open/floor/rogue/cobblerock,
/area/rogue/under/tomb/cave/lava)
"sb" = (
/mob/living/simple_animal/hostile/retaliate/rogue/bigrat,
/turf/open/floor/rogue/cobble,
/area/rogue/under/tomb/cave/lava)
"sp" = (
/turf/open/floor/rogue/dirt,
/area/rogue/under/tomb/cave/lava)
"sX" = (
/obj/structure/roguetent,
/turf/open/floor/rogue/dirt,
/area/rogue/under/tomb/indoors)
"uk" = (
/mob/living/simple_animal/hostile/retaliate/rogue/bigrat,
/turf/open/floor/rogue/dirt/road,
/area/rogue/under/tomb/cave/lava)
"uw" = (
/mob/living/simple_animal/hostile/retaliate/rogue/bigrat,
/turf/open/floor/rogue/metal,
/area/rogue/under/tomb/cave/lava)
"uE" = (
/obj/structure/fluff/railing/border{
	dir = 9
	},
/turf/open/floor/rogue/cobblerock,
/area/rogue/under/tomb/cave/lava)
"wr" = (
/obj/effect/dungeon_directional_helper/south,
/turf/open/floor/rogue/dirt/road,
/area/rogue/under/tomb/cave/lava)
"yp" = (
/turf/open/transparent/openspace,
/area/rogue/under/tomb/cave/lava)
"zf" = (
/mob/living/simple_animal/hostile/retaliate/rogue/bigrat,
/turf/open/floor/rogue/cobblerock,
/area/rogue/under/tomb/indoors)
"zW" = (
/obj/machinery/light/rogue/campfire/pyre,
/turf/open/floor/rogue/churchmarble,
/area/rogue/under/tomb/cave/lava)
"AG" = (
/obj/structure/bed/rogue/shit,
/turf/open/floor/rogue/naturalstone,
/area/rogue/under/tomb/indoors)
"Ce" = (
/turf/closed/mineral/rogue/bedrock,
/area/rogue/under/tomb/cave/lava)
"Cj" = (
/turf/open/lava/acid,
/area/rogue/under/tomb/cave/lava)
"Dw" = (
/obj/structure/flora/roguetree/burnt,
/turf/open/floor/rogue/naturalstone,
/area/rogue/under/tomb/cave/lava)
"FD" = (
/mob/living/simple_animal/hostile/retaliate/rogue/bigrat,
/turf/open/floor/rogue/ruinedwood/spiral,
/area/rogue/under/tomb/cave/lava)
"FI" = (
/obj/effect/dungeon_directional_helper/west,
/turf/open/floor/rogue/naturalstone,
/area/rogue/under/tomb/cave/lava)
"FK" = (
/obj/machinery/light/rogue/torchholder/r,
/turf/open/floor/rogue/dirt,
/area/rogue/under/tomb/indoors)
"Gf" = (
/obj/structure/fluff/railing/border{
	dir = 4
	},
/turf/open/floor/rogue/naturalstone,
/area/rogue/under/tomb/cave/lava)
"Gk" = (
/obj/machinery/light/rogue/hearth,
/turf/open/floor/rogue/naturalstone,
/area/rogue/under/tomb/cave/lava)
"Gs" = (
/obj/structure/chair/stool/rogue,
/turf/open/floor/rogue/naturalstone,
/area/rogue/under/tomb/cave/lava)
"Hq" = (
/mob/living/simple_animal/hostile/retaliate/rogue/bigrat,
/turf/open/floor/rogue/dirt,
/area/rogue/under/tomb/indoors)
"Hs" = (
/obj/effect/spawner/lootdrop/roguetown/dungeon/weapons,
/turf/open/floor/rogue/naturalstone,
/area/rogue/under/tomb/cave/lava)
"HO" = (
/obj/effect/spawner/lootdrop/general_loot_mid/x3,
/turf/open/floor/rogue/cobblerock,
/area/rogue/under/tomb/indoors)
"HQ" = (
/turf/open/floor/rogue/cobble,
/area/rogue/under/tomb/cave/lava)
"HZ" = (
/obj/structure/closet/crate/chest/wicker,
/obj/effect/spawner/lootdrop/roguetown/dungeon/misc,
/obj/effect/spawner/lootdrop/roguetown/dungeon/misc,
/obj/item/clothing/shoes/roguetown/boots/leather,
/turf/open/floor/rogue/dirt,
/area/rogue/under/tomb/indoors)
"Ib" = (
/turf/open/water/cleanshallow,
/area/rogue/under/tomb/cave/lava)
"Ie" = (
/mob/living/simple_animal/hostile/retaliate/rogue/bigrat,
/turf/open/floor/rogue/naturalstone,
/area/rogue/under/tomb/cave/lava)
"ID" = (
/obj/structure/flora/roguegrass/water/reeds,
/turf/open/water/swamp,
/area/rogue/under/tomb/cave/lava)
"IU" = (
/obj/machinery/light/rogue/firebowl/stump,
/turf/open/floor/rogue/cobblerock,
/area/rogue/under/tomb/cave/lava)
"NB" = (
/obj/structure/fluff/railing/border{
	dir = 10
	},
/turf/open/floor/rogue/naturalstone,
/area/rogue/under/tomb/cave/lava)
"NM" = (
/obj/item/roguestatue/gold,
/turf/open/floor/rogue/cobble,
/area/rogue/under/tomb/cave/lava)
"Ou" = (
/obj/item/roguebin/water/gross,
/turf/open/floor/rogue/naturalstone,
/area/rogue/under/tomb/indoors)
"Ow" = (
/turf/open/floor/rogue/dirt/road,
/area/rogue/under/tomb/cave/lava)
"OY" = (
/obj/effect/spawner/lootdrop/roguetown/dungeon/weapons,
/turf/open/floor/rogue/cobble,
/area/rogue/under/tomb/cave/lava)
"Ps" = (
/turf/open/floor/rogue/naturalstone,
/area/rogue/under/tomb/indoors)
"Rs" = (
/obj/structure/fluff/railing/border,
/turf/open/floor/rogue/dirt,
/area/rogue/under/tomb/cave/lava)
"Rw" = (
/obj/structure/fluff/railing/border{
	dir = 6
	},
/turf/open/floor/rogue/cobblerock,
/area/rogue/under/tomb/cave/lava)
"RM" = (
/turf/open/water/swamp,
/area/rogue/under/tomb/cave/lava)
"RN" = (
/obj/structure/fluff/railing/border,
/turf/open/lava/acid,
/area/rogue/under/tomb/cave/lava)
"SW" = (
/obj/structure/fluff/railing/border{
	dir = 1
	},
/turf/open/lava/acid,
/area/rogue/under/tomb/cave/lava)
"To" = (
/obj/machinery/light/rogue/firebowl/stump,
/turf/open/floor/rogue/dirt,
/area/rogue/under/tomb/cave/lava)
"TI" = (
/turf/open/floor/rogue/churchrough,
/area/rogue/under/tomb/cave/lava)
"TW" = (
/obj/structure/flora/roguegrass/water/reeds,
/turf/open/water/swamp/deep,
/area/rogue/under/tomb/cave/lava)
"Uc" = (
/obj/structure/fluff/railing/border{
	dir = 8
	},
/turf/open/floor/rogue/cobblerock,
/area/rogue/under/tomb/cave/lava)
"Ul" = (
/obj/structure/fluff/railing/border{
	dir = 8
	},
/turf/open/floor/rogue/naturalstone,
/area/rogue/under/tomb/cave/lava)
"UW" = (
/obj/effect/spawner/lootdrop/general_loot_mid,
/turf/open/floor/rogue/cobble,
/area/rogue/under/tomb/cave/lava)
"VO" = (
/obj/machinery/light/rogue/firebowl/stump,
/turf/open/floor/rogue/naturalstone,
/area/rogue/under/tomb/cave/lava)
"Wk" = (
/turf/open/floor/rogue/ruinedwood/spiral,
/area/rogue/under/tomb/cave/lava)
"Wm" = (
/obj/structure/fluff/railing/border{
	dir = 1
	},
/turf/open/floor/rogue/cobblerock,
/area/rogue/under/tomb/cave/lava)
"WC" = (
/obj/structure/fluff/railing/border{
	dir = 10
	},
/turf/open/floor/rogue/cobblerock,
/area/rogue/under/tomb/cave/lava)
"WU" = (
/obj/structure/chair/stool/rogue,
/turf/open/floor/rogue/churchrough,
/area/rogue/under/tomb/cave/lava)
"WY" = (
/turf/closed/mineral/rogue/bedrock,
/area/rogue/under/tomb/indoors)
"YK" = (
/obj/structure/fluff/railing/border,
/turf/open/floor/rogue/cobblerock,
/area/rogue/under/tomb/cave/lava)

(1,1,1) = {"
Ce
Ce
Ce
Ce
Ce
Ce
Ce
Ce
Ce
Ce
Ce
Ce
Ce
eK
eK
FI
jO
Ce
Ce
Ce
Ce
Ce
Ce
Ce
Ce
Ce
Ce
Ce
Ce
Ce
"}
(2,1,1) = {"
Ce
Ce
Ce
Ce
Ce
Ce
Ce
Ce
Ce
jO
jO
jO
eK
eK
eK
eK
mV
Gf
dY
dY
dY
dY
dY
dY
kG
Ce
Ce
Ce
Ce
Ce
"}
(3,1,1) = {"
Ce
Ce
Ce
Ce
Ce
Ce
Rw
Gf
Gf
Gf
kG
VO
eK
eK
eK
jO
jO
HQ
HQ
HQ
HQ
HQ
HQ
HQ
jO
jO
Ce
Ce
Ce
Ce
"}
(4,1,1) = {"
Ce
Ce
Ce
Ce
Ce
Ce
YK
Wk
Wk
Wk
Wm
eK
eK
eK
eK
eK
jO
me
me
me
me
me
me
me
eK
eK
jO
Ce
Ce
Ce
"}
(5,1,1) = {"
Ce
Ce
Ce
Ce
RM
sp
YK
Wk
bA
Wk
nR
eK
eK
eK
eK
eK
eK
HQ
HQ
HQ
HQ
HQ
HQ
HQ
eK
eK
jO
jO
Ce
Ce
"}
(6,1,1) = {"
Ce
Ce
Ce
RM
RM
RM
Rs
Wk
Wk
FD
Wm
eK
eK
jO
jO
eK
WC
Ul
hC
hC
hC
hC
hC
Ul
qZ
eK
nm
jO
Ce
Ce
"}
(7,1,1) = {"
Ce
WY
dk
dk
dk
dk
jA
Ul
Ul
Uc
uE
eK
jO
jO
jO
Ie
jO
jO
jO
Cj
Cj
Cj
Cj
Cj
jO
IU
eK
jO
jO
Ce
"}
(8,1,1) = {"
Ce
WY
dk
HZ
np
dk
sp
jO
eK
eK
eK
jO
jO
Gk
oW
oW
jO
jO
jO
Cj
Cj
Cj
Cj
Cj
jO
jO
jO
Dw
jO
Ce
"}
(9,1,1) = {"
Ce
dk
dk
hE
hE
sX
sp
eK
eK
eK
jO
eK
eK
Gk
oW
oW
eK
eK
jO
jO
Cj
Cj
Cj
Cj
Cj
jO
jO
jO
jO
Ce
"}
(10,1,1) = {"
Ce
dk
jL
Hq
FK
dk
eK
eK
nm
eK
jO
eK
eK
eK
jO
jO
eK
eK
IU
jO
jO
Cj
Cj
Cj
Cj
Cj
jO
eK
Ce
Ce
"}
(11,1,1) = {"
Ce
dk
jL
hE
dk
dk
eK
eK
eK
jO
jO
jO
eK
eK
jO
jO
eK
eK
eK
jO
Cj
Cj
Cj
Cj
Cj
Cj
jO
eK
Ce
Ce
"}
(12,1,1) = {"
Ce
dk
dk
dk
dk
eK
eK
jO
jO
jO
jO
jO
jO
Cj
Cj
Cj
Cj
jO
jO
Cj
Cj
Cj
Cj
Cj
Cj
jO
jO
jO
Ce
Ce
"}
(13,1,1) = {"
jO
eK
eK
eK
eK
eK
jO
oW
oW
VO
jO
Cj
Cj
Cj
Cj
Cj
Cj
Cj
Cj
Cj
Cj
Cj
Cj
Cj
jO
jO
jO
sp
sp
Ce
"}
(14,1,1) = {"
eK
eK
eK
eK
eK
eK
jO
oW
oW
jO
Cj
Cj
Cj
Cj
oW
oW
Cj
Cj
Cj
Cj
Cj
Cj
oW
oW
jO
jO
sp
sp
Ow
Ow
"}
(15,1,1) = {"
da
eK
eK
eK
eK
eK
jO
jO
jO
Cj
Cj
Cj
Cj
Cj
Cj
Cj
Cj
Cj
Cj
Cj
Cj
Cj
oW
jO
jO
sp
sp
Ow
eK
Ow
"}
(16,1,1) = {"
eK
eK
eK
IU
eK
eK
eK
jO
jO
Cj
Cj
Cj
Cj
Cj
jO
jO
jO
Cj
Cj
Cj
Cj
jO
jO
sp
sp
Ow
Ow
eK
eK
wr
"}
(17,1,1) = {"
eK
eK
jO
mV
eK
eK
eK
kG
jO
Cj
Cj
Cj
Cj
jO
jO
eK
eK
eK
jO
jO
jO
sp
sp
sp
Ow
qX
Ow
eK
eK
Ow
"}
(18,1,1) = {"
Ce
jO
jO
lt
HQ
me
HQ
ih
jO
Cj
Cj
Cj
jO
jO
eK
eK
eK
jO
jO
sp
sp
sp
sp
Ow
Ow
Ow
uk
eK
eK
sp
"}
(19,1,1) = {"
Ce
Cj
Cj
lt
HQ
me
HQ
ih
jO
Cj
Cj
Cj
jO
jO
jO
eK
jO
jO
sp
an
sp
sp
Ow
Ow
Ow
sp
sp
sp
sp
Ce
"}
(20,1,1) = {"
Ce
Cj
Cj
RN
HQ
me
HQ
ih
Cj
Cj
Cj
Cj
jO
jO
oW
oW
jO
sp
sp
sp
sp
sp
eK
eK
sp
sp
an
sp
Ce
Ce
"}
(21,1,1) = {"
Ce
Cj
Cj
RN
HQ
me
HQ
SW
Cj
Cj
Cj
Cj
jO
jO
oW
oW
sp
To
sp
sp
sp
eK
eK
eK
sp
sp
sp
Ce
Ce
Ce
"}
(22,1,1) = {"
Ce
Cj
Cj
RN
HQ
uw
HQ
SW
Cj
Cj
Cj
jO
jO
jO
sp
sp
sp
sp
sp
Ow
eK
eK
eK
sp
sp
RM
Ce
Ce
Ce
Ce
"}
(23,1,1) = {"
Ce
Cj
Cj
RN
HQ
me
HQ
SW
Cj
jO
jO
jO
RM
RM
RM
RM
sp
an
Ow
Ow
eK
eK
sp
sp
sp
RM
Ce
Ce
Ce
Ce
"}
(24,1,1) = {"
Ce
Cj
Cj
RN
HQ
me
HQ
ih
jO
jO
jO
RM
RM
jJ
jJ
RM
sp
eK
Ow
Ow
sp
To
sp
an
sp
Ce
Ce
Ce
Ce
Ce
"}
(25,1,1) = {"
Ce
Cj
Cj
RN
HQ
me
HQ
ih
jO
jO
RM
RM
jJ
TW
jJ
RM
eK
eK
Ow
sp
sp
sp
sp
ID
Ce
Ce
Ce
Ce
Ce
Ce
"}
(26,1,1) = {"
Ce
Cj
jO
lt
HQ
me
HQ
ih
eK
eK
RM
TW
jJ
jJ
RM
RM
eK
eK
sp
an
sp
RM
RM
RM
Ce
Ce
Ce
Ce
Ce
Ce
"}
(27,1,1) = {"
Ce
Ce
jO
NB
jO
jO
jO
uE
nm
eK
RM
RM
jJ
RM
RM
uk
Ow
Ow
sp
sp
sp
ID
Ce
Ce
Ce
Ce
Ce
Ce
Ce
Ce
"}
(28,1,1) = {"
Ce
Ce
Ce
jO
VO
eK
eK
eK
eK
eK
eK
RM
RM
RM
sp
Ow
Ow
sp
sp
Ce
Ce
Ce
Ce
Ce
Ce
Ce
Ce
Ce
Ce
Ce
"}
(29,1,1) = {"
Ce
Ce
Ce
Ce
jO
jO
eK
eK
jO
jO
eK
eK
eK
eK
Ow
Ow
Ow
sp
Ce
Ce
Ce
Ce
Ce
Ce
Ce
Ce
Ce
Ce
Ce
Ce
"}
(30,1,1) = {"
Ce
Ce
Ce
Ce
Ce
Ce
Ce
Ce
Ce
Ce
Ce
Ce
Ce
sp
Ow
dv
sp
Ce
Ce
Ce
Ce
Ce
Ce
Ce
Ce
Ce
Ce
Ce
Ce
Ce
"}

(1,1,2) = {"
WY
WY
WY
WY
WY
WY
Ce
Ce
Ce
Ce
Ce
Ce
Ce
jO
jO
jO
jO
Ce
Ce
Ce
Ce
Ce
Ce
Ce
Ce
Ce
Ce
Ce
Ce
Ce
"}
(2,1,2) = {"
WY
WY
AG
lE
lE
dk
Ce
Ce
Ce
yp
yp
jO
eK
jO
eK
eK
jO
eK
eK
eK
yp
yp
yp
yp
yp
jO
Ib
Ib
Ce
Ce
"}
(3,1,2) = {"
WY
Ou
lE
lE
lE
dk
yp
yp
yp
yp
yp
yp
eK
jO
jO
eK
eK
jO
jO
yp
yp
yp
yp
yp
yp
yp
jO
Ib
Ib
Ce
"}
(4,1,2) = {"
WY
AG
lE
zf
dk
dk
yp
yp
yp
yp
yp
yp
yp
yp
HQ
HQ
yp
yp
yp
yp
yp
yp
yp
yp
yp
yp
yp
jO
jO
Ce
"}
(5,1,2) = {"
WY
Ps
hK
Ps
dk
yp
yp
yp
yp
yp
yp
yp
yp
yp
eK
HQ
yp
yp
yp
yp
yp
yp
yp
yp
yp
yp
yp
yp
Ce
Ce
"}
(6,1,2) = {"
WY
hK
Ps
HO
dk
yp
yp
yp
yp
yp
yp
yp
yp
yp
eK
HQ
yp
yp
yp
yp
yp
yp
yp
yp
yp
yp
yp
yp
Ce
Ce
"}
(7,1,2) = {"
WY
WY
dk
jt
dk
jO
yp
yp
yp
yp
yp
yp
yp
HQ
sb
HQ
yp
yp
yp
yp
yp
yp
yp
yp
yp
yp
yp
yp
yp
Ce
"}
(8,1,2) = {"
Ce
Ce
eK
eK
jO
eK
yp
yp
yp
yp
yp
yp
yp
HQ
HQ
HQ
HQ
yp
yp
yp
yp
yp
yp
yp
yp
yp
yp
yp
yp
Ce
"}
(9,1,2) = {"
Ce
eK
eK
eK
jO
eK
yp
yp
yp
yp
yp
yp
HQ
HQ
HQ
HQ
HQ
HQ
yp
yp
yp
yp
yp
yp
yp
yp
yp
yp
yp
Ce
"}
(10,1,2) = {"
Ce
eK
eK
eK
eK
jO
yp
yp
yp
yp
yp
HQ
HQ
HQ
HQ
yp
rA
eK
HQ
yp
yp
yp
yp
yp
yp
yp
yp
yp
Ce
Ce
"}
(11,1,2) = {"
Ce
eK
Ie
eK
eK
jO
yp
yp
yp
yp
HQ
HQ
HQ
yp
HQ
HQ
eK
eK
eK
HQ
yp
yp
yp
yp
yp
yp
yp
yp
Ce
Ce
"}
(12,1,2) = {"
Ce
eK
jO
eK
eK
yp
yp
yp
yp
HQ
HQ
HQ
HQ
HQ
yp
HQ
yp
eK
eK
HQ
HQ
HQ
yp
yp
yp
yp
yp
sp
Ce
Ce
"}
(13,1,2) = {"
eK
jO
eK
yp
yp
yp
yp
HQ
HQ
HQ
HQ
HQ
yp
yp
yp
yp
yp
yp
HQ
yp
yp
HQ
HQ
yp
yp
yp
yp
sp
sp
Ce
"}
(14,1,2) = {"
eK
jO
eK
jO
jO
jO
HQ
HQ
HQ
HQ
HQ
yp
HQ
yp
NM
NM
yp
HQ
yp
UW
HQ
HQ
HQ
HQ
yp
yp
yp
sp
sp
sp
"}
(15,1,2) = {"
eK
eK
jO
HQ
sb
HQ
yp
yp
HQ
HQ
HQ
yp
HQ
yp
yp
yp
yp
HQ
HQ
HQ
HQ
yp
HQ
yp
yp
yp
yp
sp
Ow
Ow
"}
(16,1,2) = {"
eK
eK
jO
yp
yp
yp
yp
yp
yp
HQ
HQ
HQ
HQ
yp
HQ
OY
HQ
HQ
yp
HQ
yp
yp
yp
yp
yp
eK
eK
eK
Ow
Ow
"}
(17,1,2) = {"
jO
eK
jO
yp
yp
yp
yp
yp
yp
yp
HQ
HQ
HQ
HQ
HQ
yp
yp
HQ
HQ
HQ
yp
yp
yp
yp
HQ
HQ
HQ
Ow
Ow
Ow
"}
(18,1,2) = {"
Ce
eK
yp
yp
yp
yp
yp
yp
yp
yp
yp
HQ
HQ
HQ
yp
eK
eK
eK
HQ
yp
yp
yp
yp
yp
yp
yp
yp
Ow
sp
sp
"}
(19,1,2) = {"
Ce
jO
yp
yp
yp
yp
yp
yp
yp
yp
yp
yp
HQ
HQ
HQ
HQ
yp
HQ
yp
yp
yp
yp
yp
yp
yp
yp
yp
sp
sp
Ce
"}
(20,1,2) = {"
Ce
yp
yp
yp
yp
yp
yp
yp
yp
yp
yp
yp
yp
sb
HQ
HQ
HQ
yp
yp
yp
yp
yp
yp
yp
yp
yp
yp
sp
Ce
Ce
"}
(21,1,2) = {"
Ce
yp
yp
yp
yp
yp
yp
yp
yp
yp
yp
yp
yp
HQ
HQ
HQ
yp
yp
yp
yp
yp
yp
yp
yp
yp
yp
yp
Ce
Ce
Ce
"}
(22,1,2) = {"
Ce
yp
yp
yp
yp
yp
yp
yp
yp
yp
yp
yp
yp
yp
HQ
yp
yp
yp
yp
yp
yp
yp
yp
yp
yp
yp
jO
jO
Ce
Ce
"}
(23,1,2) = {"
Ce
yp
yp
yp
yp
yp
yp
yp
yp
yp
yp
yp
yp
yp
HQ
yp
yp
yp
yp
yp
yp
yp
yp
yp
yp
yp
jO
Gs
bJ
Ce
"}
(24,1,2) = {"
Ce
yp
yp
yp
yp
yp
yp
yp
yp
yp
yp
yp
yp
yp
HQ
yp
yp
yp
yp
yp
yp
yp
yp
yp
yp
TI
TI
TI
WU
Ce
"}
(25,1,2) = {"
Ce
yp
yp
yp
yp
yp
yp
yp
yp
yp
yp
yp
yp
HQ
HQ
HQ
yp
yp
yp
yp
yp
yp
yp
yp
TI
pO
qx
pO
TI
Ce
"}
(26,1,2) = {"
Ce
yp
yp
yp
yp
yp
yp
yp
yp
yp
yp
yp
yp
HQ
HQ
HQ
yp
yp
yp
fK
yp
yp
yp
jO
TI
zW
nJ
pO
TI
Ce
"}
(27,1,2) = {"
Ce
Ce
yp
yp
yp
yp
yp
yp
yp
yp
yp
yp
yp
HQ
HQ
yp
yp
yp
yp
yp
yp
yp
jO
jO
TI
pO
qe
pO
Ce
Ce
"}
(28,1,2) = {"
Ce
Ce
Ce
yp
yp
yp
yp
yp
yp
eK
eK
jO
eK
eK
jO
jO
jO
eK
eK
Ce
Ce
Ce
it
Hs
TI
TI
TI
TI
Ce
Ce
"}
(29,1,2) = {"
Ce
Ce
Ce
Ce
yp
yp
yp
yp
eK
eK
eK
jO
jO
eK
eK
jO
eK
eK
Ce
Ce
Ce
Ce
Ce
Ce
Ce
Ce
Ce
Ce
Ce
Ce
"}
(30,1,2) = {"
Ce
Ce
Ce
Ce
Ce
Ce
Ce
Ce
Ce
Ce
Ce
eK
jO
jO
jO
jO
eK
Ce
Ce
Ce
Ce
Ce
Ce
Ce
Ce
Ce
Ce
Ce
Ce
Ce
"}
