//MAP CONVERTED BY dmm2tgm.py THIS HEADER COMMENT PREVENTS RECONVERSION, DO NOT REMOVE
"a" = (
/turf/closed/mineral/rogue/bedrock,
/area/rogue/under/tomb/cave/lava)
"q" = (
/obj/structure/table/wood,
/obj/item/rogueweapon/hammer/iron,
/turf/open/floor/rogue/naturalstone,
/area/rogue/under/tomb/cave/lava)
"r" = (
/obj/structure/stairs/stone/d,
/turf/open/floor/rogue/cobblerock,
/area/rogue/under/tomb/cave/lava)
"t" = (
/obj/structure/table/wood,
/obj/item/rogueweapon/mace/warhammer/steel,
/turf/open/floor/rogue/cobblerock,
/area/rogue/under/tomb/cave/lava)
"u" = (
/turf/open/floor/rogue/cobblerock,
/area/rogue/under/tomb/cave/lava)
"w" = (
/obj/structure/stairs/stone/d{
	dir = 1
	},
/turf/open/floor/rogue/naturalstone,
/area/rogue/under/tomb/cave/lava)
"z" = (
/obj/machinery/light/rogue/smelter,
/turf/open/floor/rogue/cobblerock,
/area/rogue/under/tomb/cave/lava)
"B" = (
/obj/effect/dungeon_directional_helper/east,
/turf/open/floor/rogue/cobblerock,
/area/rogue/under/tomb/cave/lava)
"C" = (
/turf/open/floor/rogue/naturalstone,
/area/rogue/under/tomb/cave/lava)
"D" = (
/obj/effect/dungeon_directional_helper/south,
/turf/open/floor/rogue/cobblerock,
/area/rogue/under/tomb/cave/lava)
"G" = (
/obj/machinery/anvil,
/turf/open/floor/rogue/naturalstone,
/area/rogue/under/tomb/cave/lava)
"H" = (
/turf/open/transparent/openspace,
/area/rogue/under/tomb/cave/lava)
"L" = (
/obj/effect/dungeon_directional_helper/north,
/turf/open/floor/rogue/cobblerock,
/area/rogue/under/tomb/cave/lava)
"N" = (
/obj/structure/table/wood,
/obj/item/rogueweapon/tongs,
/turf/open/floor/rogue/cobblerock,
/area/rogue/under/tomb/cave/lava)
"O" = (
/obj/structure/stairs/stone/d{
	dir = 1
	},
/turf/open/floor/rogue/cobblerock,
/area/rogue/under/tomb/cave/lava)
"Q" = (
/obj/item/roguebin/water,
/turf/open/floor/rogue/naturalstone,
/area/rogue/under/tomb/cave/lava)
"S" = (
/obj/structure/stairs/stone/d,
/turf/open/floor/rogue/naturalstone,
/area/rogue/under/tomb/cave/lava)
"T" = (
/obj/structure/table/wood,
/turf/open/floor/rogue/naturalstone,
/area/rogue/under/tomb/cave/lava)
"U" = (
/obj/machinery/light/rogue/smelter,
/turf/open/floor/rogue/naturalstone,
/area/rogue/under/tomb/cave/lava)
"W" = (
/obj/effect/dungeon_directional_helper/west,
/turf/open/floor/rogue/naturalstone,
/area/rogue/under/tomb/cave/lava)
"X" = (
/turf/open/lava,
/area/rogue/under/tomb/cave/lava)
"Z" = (
/obj/machinery/light/rogue/forge,
/turf/open/floor/rogue/cobblerock,
/area/rogue/under/tomb/cave/lava)

(1,1,1) = {"
a
a
a
a
a
a
a
a
a
a
a
a
a
a
C
W
u
a
a
a
a
a
a
a
a
a
a
a
a
a
"}
(2,1,1) = {"
a
a
a
a
a
a
a
a
a
a
X
X
u
u
C
u
u
u
C
a
a
a
a
a
a
a
a
a
a
a
"}
(3,1,1) = {"
a
a
a
a
a
a
a
X
X
X
X
X
X
u
C
u
u
u
X
X
X
a
a
a
a
a
a
a
a
a
"}
(4,1,1) = {"
a
a
a
a
X
X
X
X
X
a
a
X
X
u
u
C
C
u
X
X
X
X
X
a
a
a
a
a
a
a
"}
(5,1,1) = {"
a
a
a
X
X
X
X
X
a
a
a
X
X
C
u
C
u
X
X
X
X
X
X
a
a
a
a
a
a
a
"}
(6,1,1) = {"
a
a
X
X
X
X
X
X
a
a
X
X
X
C
C
C
u
X
X
X
X
X
X
X
X
a
a
a
a
a
"}
(7,1,1) = {"
a
a
a
X
X
X
X
X
X
a
X
X
X
X
C
u
u
C
X
X
X
X
X
X
X
X
X
a
a
a
"}
(8,1,1) = {"
a
a
a
X
X
X
X
X
X
X
X
X
X
X
u
u
u
C
X
X
X
X
X
X
X
X
X
a
a
a
"}
(9,1,1) = {"
a
a
a
X
X
X
X
X
X
X
X
X
X
C
u
u
u
X
X
X
X
a
a
X
X
X
X
X
a
a
"}
(10,1,1) = {"
a
a
X
X
X
a
a
X
X
X
X
X
C
u
C
C
u
u
X
X
X
a
a
a
X
X
X
X
a
a
"}
(11,1,1) = {"
a
a
X
X
a
a
X
X
X
X
X
C
C
u
u
C
C
u
C
X
X
X
a
a
a
a
X
X
a
a
"}
(12,1,1) = {"
a
X
X
a
a
a
X
X
X
X
C
u
C
a
a
a
a
C
u
u
X
X
a
a
a
a
X
X
u
a
"}
(13,1,1) = {"
a
X
X
a
X
X
X
X
X
u
u
u
a
a
a
a
a
a
u
C
u
X
X
a
a
a
a
X
u
a
"}
(14,1,1) = {"
a
X
X
u
X
X
X
X
u
u
C
a
a
a
a
a
a
a
a
C
u
u
X
X
X
X
X
u
u
a
"}
(15,1,1) = {"
C
C
C
u
u
X
X
u
u
C
S
a
a
a
a
a
a
a
a
w
C
u
u
u
C
C
u
C
C
C
"}
(16,1,1) = {"
L
C
u
C
C
C
C
C
C
C
r
a
a
a
a
a
a
a
a
O
u
C
C
u
u
u
u
C
C
D
"}
(17,1,1) = {"
u
u
u
C
C
C
u
C
u
u
r
a
a
a
a
a
a
a
a
O
C
C
u
u
C
C
C
C
u
u
"}
(18,1,1) = {"
u
u
u
u
X
u
u
X
C
u
C
a
a
a
a
a
a
a
a
u
u
C
C
C
C
X
C
u
u
a
"}
(19,1,1) = {"
a
u
X
X
X
X
X
X
X
u
u
C
a
a
a
a
a
a
C
C
u
C
X
X
X
X
X
u
u
a
"}
(20,1,1) = {"
a
u
X
X
X
X
X
X
X
X
C
u
C
a
a
a
a
C
u
u
X
X
X
X
X
X
X
u
u
a
"}
(21,1,1) = {"
a
X
X
X
X
a
a
a
X
X
X
u
u
C
u
u
C
u
u
X
X
X
X
X
a
X
X
X
u
a
"}
(22,1,1) = {"
a
a
X
X
X
a
a
a
X
X
X
X
C
u
C
u
u
C
X
X
X
a
a
a
a
X
X
X
a
a
"}
(23,1,1) = {"
a
a
X
X
X
a
a
a
a
X
X
X
X
u
u
u
C
X
X
X
a
a
a
a
X
X
X
a
a
a
"}
(24,1,1) = {"
a
a
X
X
X
X
a
a
a
X
X
X
X
u
u
u
X
X
X
X
a
a
a
X
X
X
X
a
a
a
"}
(25,1,1) = {"
a
a
a
X
X
X
X
X
X
X
X
X
X
X
C
u
C
X
X
X
a
a
X
X
X
X
X
a
a
a
"}
(26,1,1) = {"
a
a
a
X
X
X
X
X
X
X
X
X
X
C
C
u
C
X
X
X
X
X
X
X
X
X
a
a
a
a
"}
(27,1,1) = {"
a
a
a
X
X
X
X
X
X
X
X
X
X
C
u
u
C
X
X
X
X
X
X
X
X
a
a
a
a
a
"}
(28,1,1) = {"
a
a
a
a
a
X
X
X
X
X
X
X
C
u
C
C
u
X
X
X
X
X
X
X
a
a
a
a
a
a
"}
(29,1,1) = {"
a
a
a
a
a
a
a
a
a
X
X
X
u
u
u
u
C
u
u
X
X
X
a
a
a
a
a
a
a
a
"}
(30,1,1) = {"
a
a
a
a
a
a
a
a
a
a
a
a
a
a
u
B
u
a
a
a
a
a
a
a
a
a
a
a
a
a
"}

(1,1,2) = {"
a
a
a
a
a
a
a
a
a
a
a
a
a
a
u
u
C
a
a
a
a
a
a
a
a
a
a
a
a
a
"}
(2,1,2) = {"
a
a
a
a
a
a
a
a
a
a
a
C
u
u
C
u
u
u
C
a
u
a
a
a
a
a
a
a
a
a
"}
(3,1,2) = {"
a
a
a
a
C
a
a
C
u
u
u
u
u
H
H
H
H
H
C
u
u
a
a
a
a
a
a
a
a
a
"}
(4,1,2) = {"
a
a
a
a
u
C
C
C
u
a
a
u
C
H
H
H
H
H
H
H
u
u
C
a
a
a
a
a
a
a
"}
(5,1,2) = {"
a
a
a
a
u
u
C
C
a
a
a
C
H
H
H
H
H
H
H
H
H
u
C
a
a
a
a
a
a
a
"}
(6,1,2) = {"
a
a
a
C
u
u
u
C
a
a
u
C
H
H
H
H
H
H
H
H
H
C
u
u
u
a
a
a
a
a
"}
(7,1,2) = {"
a
a
a
u
u
u
u
C
u
a
u
u
H
H
H
H
H
H
H
H
H
H
C
C
u
u
u
a
a
a
"}
(8,1,2) = {"
a
a
a
u
C
H
H
u
u
C
u
u
C
H
H
H
H
H
H
H
H
a
u
u
u
u
u
a
a
a
"}
(9,1,2) = {"
a
a
a
u
u
H
H
H
H
C
u
u
u
H
H
H
H
H
H
H
H
a
a
a
u
u
C
C
a
a
"}
(10,1,2) = {"
a
a
C
u
H
a
a
H
H
H
C
C
u
C
H
H
H
H
H
H
H
a
a
a
C
u
u
u
a
a
"}
(11,1,2) = {"
a
a
C
C
a
a
H
H
H
H
H
C
C
C
C
H
H
H
H
H
H
H
a
a
a
a
C
u
a
a
"}
(12,1,2) = {"
a
C
u
a
a
a
H
H
H
H
H
H
u
u
u
u
C
H
H
H
H
H
a
a
a
a
a
C
u
a
"}
(13,1,2) = {"
a
u
u
a
a
H
H
H
H
H
H
H
u
u
u
u
u
C
H
H
H
H
H
a
a
a
a
C
u
a
"}
(14,1,2) = {"
a
u
C
H
H
H
H
H
H
H
H
u
C
t
z
T
C
u
C
H
H
H
H
H
H
H
H
H
u
a
"}
(15,1,2) = {"
C
u
C
H
H
H
H
H
H
H
H
r
u
C
C
C
u
u
O
H
H
H
H
H
H
H
H
H
u
u
"}
(16,1,2) = {"
u
u
H
H
H
H
H
H
H
H
H
S
u
Z
G
Q
u
C
O
H
H
H
H
H
H
H
H
H
u
u
"}
(17,1,2) = {"
u
u
C
H
H
H
H
H
H
H
H
S
C
C
C
C
u
u
O
H
H
H
H
H
H
H
H
H
u
u
"}
(18,1,2) = {"
u
C
C
H
H
H
H
H
H
H
H
C
u
N
U
q
u
u
C
H
H
H
H
H
H
H
H
H
C
a
"}
(19,1,2) = {"
a
u
u
H
H
H
H
H
H
H
H
H
u
u
u
C
C
u
u
H
H
H
H
H
H
H
H
H
C
a
"}
(20,1,2) = {"
a
u
u
C
H
H
H
H
H
H
H
H
H
C
u
u
u
u
u
C
C
H
u
u
u
u
H
C
C
a
"}
(21,1,2) = {"
a
u
u
u
H
a
a
a
H
H
H
H
H
H
H
H
H
u
C
C
u
u
u
a
a
u
u
u
a
a
"}
(22,1,2) = {"
a
a
C
u
C
a
a
a
a
H
H
H
H
H
H
H
H
H
C
u
u
a
a
a
a
C
u
u
a
a
"}
(23,1,2) = {"
a
a
a
u
u
a
a
a
a
H
H
H
H
H
H
H
H
H
C
u
a
a
a
a
C
u
u
u
a
a
"}
(24,1,2) = {"
a
a
u
u
u
C
a
a
a
a
H
H
H
H
H
H
H
H
C
u
a
a
a
C
C
u
u
a
a
a
"}
(25,1,2) = {"
a
a
a
u
u
u
u
a
a
a
H
H
H
H
H
H
H
H
C
C
a
a
C
C
C
C
u
a
a
a
"}
(26,1,2) = {"
a
a
a
C
C
u
u
a
a
H
H
H
H
H
H
H
H
H
C
u
u
u
C
u
C
C
a
a
a
a
"}
(27,1,2) = {"
a
a
a
a
C
u
u
H
H
H
H
C
u
u
H
H
H
C
u
u
u
u
u
u
C
a
a
a
a
a
"}
(28,1,2) = {"
a
a
a
a
a
a
u
C
u
u
u
C
u
C
u
C
u
u
u
u
u
u
C
C
a
a
a
a
a
a
"}
(29,1,2) = {"
a
a
a
a
a
a
a
a
a
C
u
a
a
C
u
C
u
u
C
a
a
a
a
a
a
a
a
a
a
a
"}
(30,1,2) = {"
a
a
a
a
a
a
a
a
a
a
a
a
a
a
u
u
u
a
a
a
a
a
a
a
a
a
a
a
a
a
"}
