//MAP CONVERTED BY dmm2tgm.py THIS HEADER COMMENT PREVENTS RECONVERSION, DO NOT REMOVE
"a" = (
/turf/closed/mineral/rogue/bedrock,
/area/rogue/under/tomb/cave)
"g" = (
/obj/effect/dungeon_directional_helper/south,
/turf/open/floor/rogue/cobblerock,
/area/rogue/under/tomb/cave)
"w" = (
/turf/open/floor/rogue/cobblerock,
/area/rogue/under/tomb/cave)
"E" = (
/turf/open/floor/rogue/naturalstone,
/area/rogue/under/tomb/cave)
"I" = (
/obj/effect/dungeon_directional_helper/west,
/turf/open/floor/rogue/cobblerock,
/area/rogue/under/tomb/cave)
"R" = (
/obj/effect/dungeon_directional_helper/north,
/turf/open/floor/rogue/naturalstone,
/area/rogue/under/tomb/cave)

(1,1,1) = {"
a
a
a
a
a
a
w
I
E
a
a
a
a
a
a
"}
(2,1,1) = {"
a
a
a
a
a
a
w
E
w
E
a
a
a
a
a
"}
(3,1,1) = {"
a
a
a
a
a
w
w
E
E
E
w
a
a
a
a
"}
(4,1,1) = {"
a
a
E
a
w
E
E
w
a
E
E
w
a
E
a
"}
(5,1,1) = {"
w
E
E
w
E
w
a
a
a
E
w
w
w
E
w
"}
(6,1,1) = {"
R
w
w
E
E
w
a
a
a
w
w
E
E
w
g
"}
(7,1,1) = {"
w
w
w
w
w
a
a
a
w
E
w
w
w
w
w
"}
(8,1,1) = {"
a
w
E
w
E
E
w
E
w
E
w
a
a
a
a
"}
(9,1,1) = {"
a
a
E
w
w
w
w
E
E
a
E
w
a
a
a
"}
(10,1,1) = {"
a
a
a
a
a
a
a
a
a
a
a
a
a
a
a
"}

(1,1,2) = {"
a
a
a
a
a
a
w
w
w
a
a
a
a
a
a
"}
(2,1,2) = {"
a
a
a
a
a
a
w
w
E
E
a
a
a
a
a
"}
(3,1,2) = {"
a
a
a
a
a
E
E
E
w
w
E
a
a
a
a
"}
(4,1,2) = {"
a
a
E
a
w
w
E
E
a
w
E
E
a
w
a
"}
(5,1,2) = {"
w
w
E
w
w
E
a
a
a
E
w
E
w
w
w
"}
(6,1,2) = {"
E
w
w
w
E
E
a
a
a
w
w
w
E
w
w
"}
(7,1,2) = {"
E
w
w
E
E
a
a
a
w
E
E
E
E
w
E
"}
(8,1,2) = {"
a
E
w
w
E
E
w
w
w
w
w
a
a
a
a
"}
(9,1,2) = {"
a
a
w
E
w
E
w
w
E
a
w
E
a
a
a
"}
(10,1,2) = {"
a
a
a
a
a
a
a
a
a
a
a
a
a
a
a
"}
