//MAP CONVERTED BY dmm2tgm.py THIS HEADER COMMENT PREVENTS RECONVERSION, DO NOT REMOVE
"a" = (
/turf/closed/mineral/rogue/bedrock,
/area/rogue/under/tomb/cave)
"b" = (
/obj/effect/dungeon_directional_helper/north,
/turf/open/floor/rogue/naturalstone,
/area/rogue/under/tomb/cave)
"d" = (
/obj/effect/dungeon_directional_helper/south,
/turf/open/floor/rogue/naturalstone,
/area/rogue/under/tomb/cave)
"E" = (
/turf/open/floor/rogue/naturalstone,
/area/rogue/under/tomb/cave)
"Q" = (
/obj/effect/dungeon_directional_helper/east,
/turf/open/floor/rogue/cobblerock,
/area/rogue/under/tomb/cave)
"W" = (
/turf/open/floor/rogue/cobblerock,
/area/rogue/under/tomb/cave)

(1,1,1) = {"
a
a
a
a
a
a
a
a
a
a
a
a
a
a
a
"}
(2,1,1) = {"
a
a
a
a
a
a
a
a
a
a
a
a
a
a
a
"}
(3,1,1) = {"
a
a
W
W
E
a
a
a
a
a
a
E
W
a
a
"}
(4,1,1) = {"
a
W
W
E
E
W
W
a
a
a
E
E
W
W
a
"}
(5,1,1) = {"
W
W
E
E
E
W
a
a
a
W
W
E
a
W
W
"}
(6,1,1) = {"
b
E
E
W
a
a
a
a
a
W
E
a
a
E
d
"}
(7,1,1) = {"
W
W
E
W
W
E
a
a
a
E
E
W
W
E
E
"}
(8,1,1) = {"
a
E
W
W
E
E
a
a
E
E
W
W
a
a
a
"}
(9,1,1) = {"
a
a
a
a
E
E
W
W
E
E
W
a
a
a
a
"}
(10,1,1) = {"
a
a
a
a
a
W
W
Q
E
E
a
a
a
a
a
"}

(1,1,2) = {"
a
a
a
a
a
a
a
a
a
a
a
a
a
a
a
"}
(2,1,2) = {"
a
a
a
a
a
a
a
a
a
a
a
a
a
a
a
"}
(3,1,2) = {"
a
a
E
W
W
a
a
a
a
a
a
W
E
a
a
"}
(4,1,2) = {"
a
W
W
W
E
E
W
a
a
a
W
W
W
W
a
"}
(5,1,2) = {"
W
E
W
E
E
W
a
a
a
W
W
W
a
W
W
"}
(6,1,2) = {"
E
W
E
W
a
a
a
a
a
E
W
a
a
W
W
"}
(7,1,2) = {"
W
W
E
E
E
E
a
a
a
E
W
E
E
E
E
"}
(8,1,2) = {"
a
E
W
W
W
E
a
a
E
W
W
W
a
a
a
"}
(9,1,2) = {"
a
a
a
a
W
W
E
E
W
W
W
a
a
a
a
"}
(10,1,2) = {"
a
a
a
a
a
E
W
W
W
E
a
a
a
a
a
"}
