//MAP CONVERTED BY dmm2tgm.py THIS HEADER COMMENT PREVENTS RECONVERSION, DO NOT REMOVE
"ds" = (
/turf/open/floor/rogue/carpet,
/area/rogue/under/tomb/cave)
"ed" = (
/obj/machinery/light/rogue/firebowl/standing,
/turf/open/floor/rogue/carpet,
/area/rogue/under/tomb/cave)
"eC" = (
/turf/closed/wall/mineral/rogue/wood,
/area/rogue/under/tomb/cave)
"fu" = (
/obj/structure/fluff/walldeco/painting/seraphina,
/obj/structure/fluff/walldeco/painting/seraphina,
/turf/closed/wall/mineral/rogue/wood,
/area/rogue/under/tomb/cave)
"fy" = (
/obj/structure/flora/rogueshroom/happy/random,
/turf/open/floor/rogue/dirt/ambush,
/area/rogue/under/tomb/cave)
"fE" = (
/obj/structure/flora/rogueshroom/happy/random,
/turf/closed/mineral/rogue/bedrock,
/area/rogue/under/tomb/cave)
"ha" = (
/obj/structure/flora/roguegrass/swampweed,
/turf/open/floor/rogue/dirt/ambush,
/area/rogue/under/tomb/cave)
"iX" = (
/turf/open/floor/rogue/dirt/road,
/area/rogue/under/tomb/cave)
"jk" = (
/mob/living/simple_animal/hostile/retaliate/rogue/trufflepig,
/turf/open/water/swamp/deep,
/area/rogue/under/tomb/cave)
"jt" = (
/obj/structure/mineral_door/bars,
/turf/open/floor/rogue/blocks/paving/vert,
/area/rogue/under/tomb/cave)
"jG" = (
/obj/structure/flora/rogueshroom/happy/random,
/turf/open/floor/rogue/dirt/road,
/area/rogue/under/tomb/cave)
"kc" = (
/obj/structure/fluff/walldeco/painting/skull,
/turf/closed/wall/mineral/rogue/wood,
/area/rogue/under/tomb/cave)
"my" = (
/mob/living/simple_animal/hostile/retaliate/rogue/minotaur/axe,
/turf/open/floor/rogue/tile/checkeralt,
/area/rogue/under/tomb/cave)
"nq" = (
/obj/machinery/light/rogue/wallfire/candle/l,
/turf/open/floor/rogue/carpet,
/area/rogue/under/tomb/cave)
"oX" = (
/obj/structure/table/wood/fancy/royalblack,
/obj/effect/spawner/lootdrop/valuable_tableware_spawner,
/obj/item/reagent_containers/food/snacks/rogue/cheddar/aged,
/turf/open/floor/rogue/carpet,
/area/rogue/under/tomb/cave)
"qw" = (
/obj/machinery/light/rogue/torchholder/c,
/obj/structure/flora/roguegrass/swampweed,
/turf/open/floor/rogue/dirt/ambush,
/area/rogue/under/tomb/cave)
"rf" = (
/obj/structure/fluff/walldeco/painting,
/turf/closed/wall/mineral/rogue/wood,
/area/rogue/under/tomb/cave)
"rh" = (
/obj/structure/bed/rogue/shit,
/turf/open/floor/rogue/blocks/paving/vert,
/area/rogue/under/tomb/cave)
"rI" = (
/turf/open/floor/rogue/dirt/ambush,
/area/rogue/under/tomb/cave)
"rO" = (
/obj/machinery/light/rogue/torchholder/c,
/mob/living/simple_animal/hostile/retaliate/rogue/trufflepig,
/turf/open/floor/rogue/dirt/ambush,
/area/rogue/under/tomb/cave)
"rV" = (
/turf/open/floor/rogue/blocks/paving/vert,
/area/rogue/under/tomb/cave)
"sa" = (
/obj/machinery/light/rogue/torchholder/r,
/obj/effect/landmark/chest_or_mimic,
/obj/item/reagent_containers/food/snacks/rogue/cheddar/aged,
/turf/open/floor/rogue/blocks/paving/vert,
/area/rogue/under/tomb/cave)
"sI" = (
/obj/machinery/light/rogue/wallfire/candle/l,
/turf/open/floor/rogue/tile/checkeralt,
/area/rogue/under/tomb/cave)
"sS" = (
/turf/open/water/swamp/deep,
/area/rogue/under/tomb/cave)
"tb" = (
/obj/structure/fluff/walldeco/rpainting/forest,
/turf/closed/wall/mineral/rogue/wood,
/area/rogue/under/tomb/cave)
"tk" = (
/obj/structure/mineral_door/wood/fancywood,
/turf/open/floor/rogue/carpet,
/area/rogue/under/tomb/cave)
"uF" = (
/obj/structure/table/wood,
/obj/item/rogueweapon/pitchfork/copper,
/obj/item/reagent_containers/glass/cup/wooden,
/obj/item/clothing/mask/cigarette/pipe/crafted,
/obj/item/reagent_containers/food/snacks/grown/rogue/swampweeddry,
/turf/open/floor/rogue/blocks/paving/vert,
/area/rogue/under/tomb/cave)
"uG" = (
/obj/machinery/light/rogue/torchholder/r,
/turf/open/floor/rogue/dirt/ambush,
/area/rogue/under/tomb/cave)
"ww" = (
/obj/machinery/light/rogue/torchholder/c,
/turf/open/floor/rogue/dirt/road,
/area/rogue/under/tomb/cave)
"wU" = (
/obj/machinery/light/rogue/torchholder/l,
/obj/structure/fermentation_keg/water,
/turf/open/floor/rogue/blocks/paving/vert,
/area/rogue/under/tomb/cave)
"zI" = (
/obj/structure/flora/roguegrass/swampweed,
/turf/open/floor/rogue/dirt/road,
/area/rogue/under/tomb/cave)
"zN" = (
/obj/structure/chair/stool/rogue,
/turf/open/floor/rogue/blocks/paving/vert,
/area/rogue/under/tomb/cave)
"BA" = (
/obj/structure/fluff/walldeco/rpainting/crown,
/turf/closed/wall/mineral/rogue/wood,
/area/rogue/under/tomb/cave)
"Ev" = (
/obj/structure/table/wood/fancy/royalblack,
/obj/effect/spawner/lootdrop/valuable_candle_spawner,
/obj/item/reagent_containers/food/snacks/rogue/cheddar/aged,
/turf/open/floor/rogue/carpet,
/area/rogue/under/tomb/cave)
"EA" = (
/obj/machinery/light/rogue/wallfire/candle/l,
/obj/structure/fluff/statue/knight/interior,
/turf/open/floor/rogue/tile/checkeralt,
/area/rogue/under/tomb/cave)
"Fh" = (
/obj/machinery/light/rogue/torchholder/l,
/turf/open/floor/rogue/dirt/road,
/area/rogue/under/tomb/cave)
"Fw" = (
/obj/machinery/light/rogue/torchholder/r,
/turf/open/floor/rogue/dirt/road,
/area/rogue/under/tomb/cave)
"FE" = (
/obj/machinery/light/rogue/wallfire/candle/r,
/obj/structure/fluff/statue/knight/interior/r,
/turf/open/floor/rogue/tile/checkeralt,
/area/rogue/under/tomb/cave)
"Hu" = (
/obj/structure/table/wood/fancy/royalblack,
/obj/item/clothing/mask/rogue/facemask/goldmask,
/obj/item/roguecoin/gold/pile,
/obj/item/storage/belt/rogue/leather/plaquegold,
/obj/item/reagent_containers/food/snacks/rogue/cheddar/aged,
/obj/item/reagent_containers/food/snacks/rogue/cheddar/aged,
/obj/item/lockpick,
/obj/item/lockpick,
/obj/item/lockpick,
/obj/item/lockpick,
/obj/item/lockpick,
/obj/item/lockpickring,
/obj/effect/landmark/chest_or_mimic,
/turf/open/floor/rogue/carpet,
/area/rogue/under/tomb/cave)
"Kf" = (
/obj/structure/table/wood/fancy/royalblack,
/obj/effect/spawner/lootdrop/valuable_clutter_spawner,
/obj/item/reagent_containers/food/snacks/rogue/cheddar/aged,
/turf/open/floor/rogue/carpet,
/area/rogue/under/tomb/cave)
"Kt" = (
/turf/closed/mineral/rogue/bedrock,
/area/rogue/under/tomb/cave)
"Ln" = (
/obj/machinery/light/rogue/torchholder/c,
/turf/open/floor/rogue/dirt/ambush,
/area/rogue/under/tomb/cave)
"Ng" = (
/obj/machinery/light/rogue/wallfire/candle/r,
/turf/open/floor/rogue/tile/checkeralt,
/area/rogue/under/tomb/cave)
"Oz" = (
/mob/living/simple_animal/hostile/retaliate/rogue/trufflepig,
/turf/open/floor/rogue/dirt/ambush,
/area/rogue/under/tomb/cave)
"PZ" = (
/obj/machinery/light/rogue/torchholder/l,
/obj/structure/flora/roguegrass/swampweed,
/turf/open/floor/rogue/dirt/ambush,
/area/rogue/under/tomb/cave)
"RZ" = (
/obj/structure/table/wood/fancy/royalblack,
/obj/effect/spawner/lootdrop/valuable_jewelry_spawner,
/obj/item/reagent_containers/food/snacks/rogue/cheddar/aged,
/turf/open/floor/rogue/carpet,
/area/rogue/under/tomb/cave)
"TV" = (
/obj/structure/table/wood/fancy/royalblack,
/obj/effect/spawner/lootdrop/cheap_clutter_spawner,
/obj/item/reagent_containers/food/snacks/rogue/cheddar/aged,
/turf/open/floor/rogue/carpet,
/area/rogue/under/tomb/cave)
"WT" = (
/mob/living/simple_animal/hostile/retaliate/rogue/trufflepig,
/turf/open/floor/rogue/dirt/road,
/area/rogue/under/tomb/cave)
"Xb" = (
/obj/structure/fluff/walldeco/painting/queen,
/turf/closed/wall/mineral/rogue/wood,
/area/rogue/under/tomb/cave)
"Xd" = (
/obj/machinery/light/rogue/wallfire/candle/r,
/turf/open/floor/rogue/carpet,
/area/rogue/under/tomb/cave)
"Yk" = (
/turf/open/floor/rogue/tile/checkeralt,
/area/rogue/under/tomb/cave)
"Yu" = (
/obj/structure/fluff/statue/evil,
/turf/open/floor/rogue/tile/checkeralt,
/area/rogue/under/tomb/cave)
"YO" = (
/turf/open/water/swamp,
/area/rogue/under/tomb/cave)

(1,1,1) = {"
Kt
Kt
ww
Kt
Kt
Kt
Kt
ww
Kt
Kt
ww
Kt
Kt
"}
(2,1,1) = {"
Kt
jG
rI
PZ
Kt
Kt
jG
iX
Kt
Kt
rI
iX
Kt
"}
(3,1,1) = {"
Kt
rO
rI
iX
jG
Kt
WT
iX
jG
Kt
fy
Oz
Kt
"}
(4,1,1) = {"
iX
iX
iX
iX
iX
Kt
Kt
rI
ha
Kt
zI
Fw
Kt
"}
(5,1,1) = {"
Kt
Kt
Kt
YO
YO
YO
Fh
rI
Kt
Kt
rI
Kt
Kt
"}
(6,1,1) = {"
Kt
rh
Kt
Kt
sS
Kt
jG
iX
iX
rI
rI
iX
iX
"}
(7,1,1) = {"
Kt
rV
wU
Kt
Kt
Kt
Kt
iX
Kt
Kt
qw
iX
Kt
"}
(8,1,1) = {"
Kt
rV
rV
rV
jt
rI
iX
rI
PZ
Kt
jG
iX
Kt
"}
(9,1,1) = {"
Kt
zN
uF
rV
Kt
Ln
YO
YO
YO
Kt
Kt
iX
Kt
"}
(10,1,1) = {"
Kt
sa
Kt
Kt
Kt
iX
Kt
YO
jG
Kt
Kt
ww
Kt
"}
(11,1,1) = {"
Kt
Kt
Kt
fy
rI
iX
Kt
YO
Kt
Kt
rI
WT
Kt
"}
(12,1,1) = {"
iX
iX
iX
rI
uG
rI
Kt
jk
Kt
rI
rI
fE
Kt
"}
(13,1,1) = {"
Kt
ww
Kt
Kt
Kt
iX
Kt
Kt
Kt
ww
Kt
Kt
Kt
"}

(1,1,2) = {"
eC
eC
tk
eC
eC
tk
eC
BA
tk
eC
eC
tk
eC
"}
(2,1,2) = {"
tk
nq
ds
Yk
EA
ds
sI
Yk
ds
sI
Yk
ds
eC
"}
(3,1,2) = {"
eC
Yk
TV
ds
ds
ds
ed
ds
ds
ds
TV
ds
tk
"}
(4,1,2) = {"
Xb
Yk
ds
Yk
ds
Yk
Yu
Yk
ds
Yk
ds
Yk
eC
"}
(5,1,2) = {"
tk
ds
ds
ds
Kf
ds
ds
ds
oX
ds
ds
Yk
eC
"}
(6,1,2) = {"
eC
Yk
ds
Yk
ds
my
ds
my
ds
Yk
ds
ds
tk
"}
(7,1,2) = {"
rf
Yk
ed
Yu
ds
ds
Hu
ds
ds
Yu
ed
Yk
eC
"}
(8,1,2) = {"
tk
ds
ds
Yk
ds
my
ds
my
ds
Yk
ds
Yk
fu
"}
(9,1,2) = {"
eC
Yk
ds
ds
Ev
ds
ds
ds
RZ
ds
ds
ds
tk
"}
(10,1,2) = {"
eC
Yk
ds
Yk
ds
Yk
Yu
Yk
ds
Yk
ds
Yk
eC
"}
(11,1,2) = {"
tk
ds
TV
ds
ds
ds
ed
ds
ds
ds
TV
Yk
kc
"}
(12,1,2) = {"
eC
ds
Ng
Yk
ds
Ng
Yk
ds
FE
Yk
ds
Xd
tk
"}
(13,1,2) = {"
eC
tk
eC
eC
tk
eC
tb
tk
eC
eC
tk
eC
eC
"}
