//MAP CONVERTED BY dmm2tgm.py THIS HEADER COMMENT PREVENTS RECONVERSION, DO NOT REMOVE
"ab" = (
/turf/open/floor/rogue/cobblerock,
/area/rogue/under/tomb/cave)
"ae" = (
/obj/structure/fluff/walldeco/vinez/r,
/obj/structure/fluff/walldeco/vinez/l,
/obj/structure/mineral_door/wood/violet,
/turf/open/floor/rogue/cobblerock,
/area/rogue/under/tomb/cave)
"ah" = (
/obj/structure/fluff/walldeco/vinez/l,
/obj/structure/fluff/walldeco/vinez/r,
/obj/structure/mineral_door/wood/violet,
/turf/open/floor/rogue/cobblerock,
/area/rogue/under/tomb/cave)
"aj" = (
/obj/structure/fluff/walldeco/vinez/l,
/obj/machinery/light/rogue/wallfire/candle/blue/l,
/turf/open/floor/rogue/cobblerock,
/area/rogue/under/tomb/cave)
"ak" = (
/obj/structure/fluff/walldeco/vinez/r,
/turf/closed/wall/mineral/rogue/stonebrick,
/area/rogue/under/tomb/cave)
"ar" = (
/turf/closed/wall/mineral/rogue/stone/moss,
/area/rogue/under/tomb/cave)
"au" = (
/obj/structure/fluff/walldeco/vinez/l,
/obj/machinery/light/rogue/wallfire/candle/blue/l,
/obj/item/reagent_containers/glass/bottle/rogue/whitewine,
/turf/open/floor/rogue/cobblerock,
/area/rogue/under/tomb/cave)
"aA" = (
/obj/item/clothing/suit/roguetown/shirt/tunic/blue,
/obj/item/clothing/shoes/roguetown/boots/leather,
/obj/item/clothing/neck/roguetown/psicross/malum,
/obj/item/clothing/ring/sapphires,
/obj/item/storage/belt/rogue/leather/plaquesilver,
/obj/item/rogueweapon/sword/rapier/dec,
/obj/item/clothing/head/roguetown/hatblu,
/obj/item/clothing/cloak/raincloak/blue,
/obj/item/clothing/gloves/roguetown/leather/black,
/obj/effect/mapping_helpers/floor_clothing_equipper,
/obj/item/clothing/neck/roguetown/psicross/inhumen/aalloy,
/mob/living/carbon/human/species/skeleton/npc/hard/noequip,
/turf/open/floor/rogue/cobblerock,
/area/rogue/under/tomb/cave)
"aG" = (
/obj/structure/mineral_door/wood/violet,
/obj/structure/spider/stickyweb,
/turf/open/floor/rogue/churchmarble,
/area/rogue/under/tomb/cave)
"aH" = (
/obj/structure/mineral_door/wood/violet,
/obj/effect/dungeon_directional_helper/east,
/turf/open/floor/rogue/cobblerock,
/area/rogue/under/tomb/cave)
"aJ" = (
/obj/structure/well,
/obj/item/reagent_containers/glass/bucket,
/turf/open/floor/rogue/cobblerock,
/area/rogue/under/tomb/cave)
"aL" = (
/obj/structure/spider/stickyweb,
/turf/open/floor/rogue/churchmarble,
/area/rogue/under/tomb/cave)
"aM" = (
/obj/machinery/light/rogue/wallfire/candle/blue/l,
/turf/open/floor/rogue/cobblerock,
/area/rogue/under/tomb/cave)
"aN" = (
/obj/structure/fluff/walldeco/vinez/r,
/obj/machinery/light/rogue/wallfire/candle/blue/r,
/turf/open/floor/rogue/cobblerock,
/area/rogue/under/tomb/cave)
"aP" = (
/turf/closed/wall/mineral/rogue/stonebrick,
/area/rogue/under/tomb/cave)
"aQ" = (
/obj/structure/table/vtable,
/obj/item/clothing/gloves/roguetown/elven_gloves,
/obj/item/clothing/head/roguetown/helmet/heavy/elven_helm,
/obj/item/clothing/suit/roguetown/shirt/undershirt/webs,
/obj/item/clothing/under/roguetown/webs,
/obj/item/clothing/cloak/raincloak/purple,
/turf/open/floor/rogue/churchmarble,
/area/rogue/under/tomb/cave)
"aT" = (
/obj/structure/fluff/walldeco/vinez/r,
/obj/machinery/light/rogue/wallfire/candle/blue/r,
/obj/item/rogue/instrument/flute,
/turf/open/floor/rogue/cobblerock,
/area/rogue/under/tomb/cave)
"aU" = (
/obj/structure/mineral_door/wood/violet,
/obj/effect/dungeon_directional_helper/west,
/turf/open/floor/rogue/cobblerock,
/area/rogue/under/tomb/cave)
"aV" = (
/obj/structure/fluff/walldeco/vinez/l,
/turf/closed/wall/mineral/rogue/stonebrick,
/area/rogue/under/tomb/cave)
"aX" = (
/obj/machinery/light/rogue/wallfire/candle/blue/r,
/obj/effect/dungeon_directional_helper/north,
/turf/open/floor/rogue/cobblerock,
/area/rogue/under/tomb/cave)
"aY" = (
/obj/effect/dungeon_directional_helper/south,
/turf/open/floor/rogue/cobblerock,
/area/rogue/under/tomb/cave)
"cl" = (
/obj/structure/spider/stickyweb,
/mob/living/simple_animal/hostile/retaliate/rogue/spider/mutated,
/turf/open/floor/rogue/churchmarble,
/area/rogue/under/tomb/cave)
"eF" = (
/obj/structure/table/vtable/v2,
/obj/item/reagent_containers/glass/bottle/rogue/wine/sourwine,
/obj/item/candle/skull/lit,
/obj/item/reagent_containers/glass/bottle/rogue/healthpotnew,
/obj/item/needle,
/obj/item/natural/bundle/silk,
/obj/item/natural/cloth,
/obj/item/natural/cloth,
/obj/item/natural/cloth,
/turf/open/floor/rogue/churchmarble,
/area/rogue/under/tomb/cave)
"ij" = (
/obj/structure/spider/stickyweb,
/obj/machinery/light/rogue/wallfire/candle/blue/l,
/turf/open/floor/rogue/churchmarble,
/area/rogue/under/tomb/cave)
"pm" = (
/mob/living/simple_animal/hostile/retaliate/rogue/spider/mutated,
/turf/open/floor/rogue/churchmarble,
/area/rogue/under/tomb/cave)
"rk" = (
/obj/structure/fluff/statue/spider,
/turf/open/floor/rogue/churchmarble,
/area/rogue/under/tomb/cave)
"rT" = (
/turf/open/floor/rogue/churchmarble,
/area/rogue/under/tomb/cave)
"ue" = (
/obj/structure/spider/stickyweb,
/obj/machinery/light/rogue/wallfire/candle/blue/r,
/turf/open/floor/rogue/churchmarble,
/area/rogue/under/tomb/cave)
"Fr" = (
/obj/structure/chair/bench/couchablack/r,
/turf/open/floor/rogue/churchmarble,
/area/rogue/under/tomb/cave)
"RZ" = (
/obj/structure/chair/bench/couchablack,
/turf/open/floor/rogue/churchmarble,
/area/rogue/under/tomb/cave)
"UN" = (
/obj/item/chair/rogue,
/turf/open/floor/rogue/churchmarble,
/area/rogue/under/tomb/cave)

(1,1,1) = {"
aP
aP
aP
aU
aP
aP
aP
aP
"}
(2,1,1) = {"
ab
aV
aj
ab
au
aV
aM
aY
"}
(3,1,1) = {"
aX
ah
aA
aJ
ab
ae
ab
aP
"}
(4,1,1) = {"
aP
ak
aN
ab
aT
ak
aP
aP
"}
(5,1,1) = {"
aP
aP
aP
aH
aP
aP
aP
aP
"}

(1,1,2) = {"
ar
ar
ar
aG
ar
ar
ar
ar
"}
(2,1,2) = {"
ar
RZ
rT
cl
ij
rT
aL
aG
"}
(3,1,2) = {"
ar
Fr
aL
rk
pm
aL
aQ
ar
"}
(4,1,2) = {"
aG
cl
rT
ue
aL
UN
eF
ar
"}
(5,1,2) = {"
ar
ar
ar
ar
aG
ar
ar
ar
"}
