//MAP CONVERTED BY dmm2tgm.py THIS HEADER COMMENT PREVENTS RECONVERSION, DO NOT REMOVE
"bI" = (
/mob/living/simple_animal/hostile/retaliate/rogue/spider,
/turf/open/floor/rogue/cobble,
/area/rogue/under/tomb)
"bU" = (
/obj/structure/spider/stickyweb,
/obj/structure/spider/stickyweb,
/turf/open/floor/rogue/cobble,
/area/rogue/under/tomb)
"cB" = (
/obj/structure/spider/stickyweb,
/obj/structure/spider/stickyweb/solo,
/turf/open/floor/rogue/cobblerock,
/area/rogue/under/tomb)
"cN" = (
/obj/structure/flora/roguegrass/water/reeds,
/turf/open/water/river,
/area/rogue/under/tomb)
"cP" = (
/obj/structure/fluff/walldeco/vinez,
/turf/closed/wall/mineral/rogue/stone/window,
/area/rogue/under/tomb)
"ed" = (
/obj/effect/spawner/lootdrop/roguetown/dungeon/armor,
/turf/open/floor/rogue/cobble,
/area/rogue/under/tomb)
"eO" = (
/obj/structure/spider/stickyweb,
/obj/structure/spider/stickyweb,
/obj/structure/spider/stickyweb/solo,
/turf/open/floor/rogue/cobble,
/area/rogue/under/tomb)
"eY" = (
/obj/structure/bookcase/random,
/obj/structure/spider/stickyweb{
	dir = 8
	},
/turf/open/floor/rogue/cobblerock,
/area/rogue/under/tomb)
"fG" = (
/obj/structure/mineral_door/bars,
/obj/structure/fluff/walldeco/vinez,
/obj/structure/fluff/walldeco/vinez,
/turf/open/floor/rogue/cobblerock,
/area/rogue/under/tomb)
"gh" = (
/obj/structure/spider/stickyweb,
/obj/structure/spider/stickyweb/solo,
/turf/open/floor/rogue/cobble,
/area/rogue/under/tomb)
"gR" = (
/obj/structure/flora/roguegrass/water/reeds,
/turf/open/water/river{
	dir = 1
	},
/area/rogue/under/tomb)
"iT" = (
/obj/effect/dungeon_directional_helper/south,
/turf/open/floor/rogue/cobblerock,
/area/rogue/under/tomb)
"js" = (
/obj/structure/stairs/stone{
	dir = 1
	},
/turf/open/floor/rogue/cobblerock,
/area/rogue/under/tomb)
"jC" = (
/obj/structure/spider/stickyweb,
/obj/machinery/light/rogue/wallfire/candle,
/turf/open/floor/rogue/cobblerock,
/area/rogue/under/tomb)
"jP" = (
/obj/effect/spawner/lootdrop/general_loot_hi,
/turf/open/floor/rogue/cobblerock,
/area/rogue/under/tomb)
"kc" = (
/obj/structure/flora/roguegrass/water,
/obj/structure/flora/roguegrass/water/reeds,
/turf/open/water/river,
/area/rogue/under/tomb)
"kA" = (
/obj/structure/spider/stickyweb,
/obj/structure/spider/stickyweb/solo,
/obj/effect/spawner/lootdrop/general_loot_mid,
/turf/open/floor/rogue/cobblerock,
/area/rogue/under/tomb)
"kG" = (
/turf/closed/wall/mineral/rogue/stone/window/moss,
/area/rogue/under/tomb)
"kU" = (
/obj/structure/spider/cocoon,
/obj/structure/spider/stickyweb,
/turf/open/floor/rogue/cobble,
/area/rogue/under/tomb)
"lf" = (
/obj/effect/dungeon_directional_helper/east,
/turf/open/floor/rogue/cobblerock,
/area/rogue/under/tomb)
"lQ" = (
/turf/open/transparent/openspace,
/area/rogue/under/tomb)
"ml" = (
/turf/closed/wall/mineral/rogue/stone/moss,
/area/rogue/under/tomb)
"mM" = (
/turf/open/water/river{
	dir = 1
	},
/area/rogue/under/tomb)
"mZ" = (
/turf/open/floor/rogue/cobblerock,
/area/rogue/under/tomb)
"nn" = (
/obj/structure/spider/stickyweb,
/obj/effect/spawner/lootdrop/roguetown/dungeon/misc,
/turf/open/floor/rogue/cobblerock,
/area/rogue/under/tomb)
"oa" = (
/obj/machinery/light/rogue/wallfire/candle,
/obj/structure/fluff/walldeco/vinez,
/turf/closed/wall/mineral/rogue/stone/moss,
/area/rogue/under/tomb)
"oF" = (
/obj/effect/spawner/lootdrop/roguetown/dungeon/weapons,
/turf/open/floor/rogue/cobble,
/area/rogue/under/tomb)
"pN" = (
/obj/structure/flora/roguegrass/water,
/obj/structure/flora/roguegrass/water/reeds,
/obj/structure/flora/roguegrass/water/reeds,
/turf/open/water/river{
	dir = 8
	},
/area/rogue/under/tomb)
"pS" = (
/obj/structure/mineral_door/bars,
/obj/structure/trap/saw_blades,
/obj/structure/fluff/walldeco/vinez,
/turf/open/floor/rogue/cobblerock,
/area/rogue/under/tomb)
"qg" = (
/obj/machinery/light/rogue/campfire/densefire,
/turf/open/floor/rogue/cobblerock,
/area/rogue/under/tomb)
"qj" = (
/obj/structure/spider/stickyweb,
/obj/structure/spider/stickyweb{
	dir = 8
	},
/turf/open/floor/rogue/cobblerock,
/area/rogue/under/tomb)
"qH" = (
/obj/structure/flora/roguegrass/water,
/obj/structure/flora/roguegrass/water/reeds,
/turf/open/water/river{
	dir = 1
	},
/area/rogue/under/tomb)
"qI" = (
/obj/structure/fluff/walldeco/vinez,
/turf/closed/wall/mineral/rogue/stone/moss,
/area/rogue/under/tomb)
"rD" = (
/obj/machinery/light/rogue/wallfire/candle,
/turf/open/floor/rogue/cobblerock,
/area/rogue/under/tomb)
"rQ" = (
/obj/structure/closet/crate/coffin,
/obj/structure/spider/stickyweb,
/obj/effect/spawner/lootdrop/roguetown/dungeon/weapons,
/turf/open/floor/rogue/cobble,
/area/rogue/under/tomb)
"rU" = (
/obj/structure/flora/roguegrass/water,
/turf/open/water/river{
	dir = 1
	},
/area/rogue/under/tomb)
"sH" = (
/obj/structure/flora/roguegrass/water,
/turf/open/water/river,
/area/rogue/under/tomb)
"sR" = (
/obj/structure/rack/rogue/shelf/biggest,
/obj/structure/spider/stickyweb,
/obj/effect/spawner/lootdrop/general_loot_low,
/turf/open/floor/rogue/cobble,
/area/rogue/under/tomb)
"tS" = (
/obj/structure/flora/roguegrass/water,
/obj/structure/flora/roguegrass/water/reeds,
/turf/open/water/river{
	dir = 4
	},
/area/rogue/under/tomb)
"ue" = (
/obj/structure/flora/roguegrass/water/reeds,
/obj/structure/flora/roguegrass/water/reeds,
/turf/open/water/river{
	dir = 1
	},
/area/rogue/under/tomb)
"uh" = (
/obj/structure/rack/rogue/shelf/biggest,
/obj/structure/spider/stickyweb,
/obj/effect/spawner/lootdrop/roguetown/dungeon/misc,
/turf/open/floor/rogue/cobblerock,
/area/rogue/under/tomb)
"un" = (
/obj/effect/waterfall,
/turf/open/transparent/openspace,
/area/rogue/under/tomb)
"uS" = (
/obj/structure/spider/stickyweb,
/obj/structure/spider/stickyweb,
/obj/structure/spider/stickyweb{
	dir = 4
	},
/turf/open/floor/rogue/cobble,
/area/rogue/under/tomb)
"vb" = (
/obj/effect/waterfall,
/turf/open/water/river{
	dir = 8
	},
/area/rogue/under/tomb)
"wt" = (
/turf/open/water/river{
	dir = 4
	},
/area/rogue/under/tomb)
"wA" = (
/obj/structure/bed/rogue/shit,
/turf/open/floor/rogue/cobble,
/area/rogue/under/tomb)
"wE" = (
/obj/structure/spider/stickyweb,
/turf/open/floor/rogue/cobble,
/area/rogue/under/tomb)
"wG" = (
/obj/structure/flora/roguegrass/water,
/turf/open/water/river{
	dir = 8
	},
/area/rogue/under/tomb)
"xc" = (
/obj/structure/spider/stickyweb,
/mob/living/simple_animal/hostile/retaliate/rogue/spider,
/turf/open/floor/rogue/cobblerock,
/area/rogue/under/tomb)
"xd" = (
/obj/structure/fluff/walldeco/vinez,
/turf/open/floor/rogue/cobble,
/area/rogue/under/tomb)
"xw" = (
/obj/structure/rack/rogue/shelf/biggest,
/obj/structure/spider/stickyweb/solo,
/obj/effect/spawner/lootdrop/general_loot_low,
/turf/open/floor/rogue/cobble,
/area/rogue/under/tomb)
"xG" = (
/obj/structure/stairs/stone,
/turf/open/floor/rogue/cobble,
/area/rogue/under/tomb)
"yj" = (
/obj/effect/waterfall,
/turf/closed/wall/mineral/rogue/stone/moss,
/area/rogue/under/tomb)
"yD" = (
/obj/structure/mineral_door/bars,
/obj/structure/fluff/walldeco/vinez,
/turf/open/floor/rogue/cobble,
/area/rogue/under/tomb)
"zk" = (
/obj/structure/spider/stickyweb,
/obj/structure/trap/shock,
/turf/open/floor/rogue/cobblerock,
/area/rogue/under/tomb)
"zQ" = (
/obj/structure/mineral_door/bars,
/obj/machinery/light/rogue/wallfire/candle,
/obj/structure/fluff/walldeco/vinez,
/turf/open/floor/rogue/cobble,
/area/rogue/under/tomb)
"Bj" = (
/obj/structure/bookcase/random,
/obj/structure/spider/stickyweb,
/turf/open/floor/rogue/cobble,
/area/rogue/under/tomb)
"Ct" = (
/obj/structure/trap/shock,
/turf/open/floor/rogue/cobble,
/area/rogue/under/tomb)
"CJ" = (
/obj/structure/closet/crate/chest,
/obj/effect/spawner/lootdrop/general_loot_low,
/obj/effect/spawner/lootdrop/roguetown/dungeon/food,
/turf/open/floor/rogue/cobble,
/area/rogue/under/tomb)
"Db" = (
/obj/machinery/light/rogue/wallfire/candle,
/turf/open/transparent/openspace,
/area/rogue/under/tomb)
"Ee" = (
/obj/machinery/light/rogue/wallfire/candle,
/turf/open/floor/rogue/cobble,
/area/rogue/under/tomb)
"EL" = (
/obj/structure/stairs/stone{
	dir = 1
	},
/turf/open/floor/rogue/cobble,
/area/rogue/under/tomb)
"FX" = (
/obj/structure/mineral_door/bars,
/obj/structure/fluff/walldeco/vinez,
/turf/open/floor/rogue/cobblerock,
/area/rogue/under/tomb)
"HX" = (
/obj/structure/closet/crate/coffin,
/obj/structure/spider/stickyweb,
/obj/structure/spider/stickyweb{
	dir = 4
	},
/turf/open/floor/rogue/cobble,
/area/rogue/under/tomb)
"Ig" = (
/obj/structure/spider/stickyweb,
/turf/open/floor/rogue/cobblerock,
/area/rogue/under/tomb)
"Is" = (
/obj/structure/mineral_door/bars,
/obj/machinery/light/rogue/wallfire/candle,
/turf/open/floor/rogue/cobblerock,
/area/rogue/under/tomb)
"Iu" = (
/obj/structure/spider/stickyweb,
/obj/structure/spider/stickyweb{
	dir = 4
	},
/turf/open/floor/rogue/cobblerock,
/area/rogue/under/tomb)
"Jw" = (
/obj/structure/spider/stickyweb,
/obj/structure/spider/stickyweb,
/obj/structure/spider/stickyweb,
/turf/open/floor/rogue/cobblerock,
/area/rogue/under/tomb)
"JF" = (
/obj/structure/spider/stickyweb,
/obj/structure/trap/wall_projectile,
/turf/open/floor/rogue/cobblerock,
/area/rogue/under/tomb)
"JM" = (
/obj/structure/bed/rogue/shit,
/turf/open/floor/rogue/cobblerock,
/area/rogue/under/tomb)
"JR" = (
/obj/effect/dungeon_directional_helper/west,
/turf/open/floor/rogue/cobblerock,
/area/rogue/under/tomb)
"Kg" = (
/turf/open/floor/rogue/cobble,
/area/rogue/under/tomb)
"Kk" = (
/obj/structure/spider/stickyweb,
/obj/structure/spider/stickyweb,
/mob/living/simple_animal/hostile/retaliate/rogue/spider,
/turf/open/floor/rogue/cobblerock,
/area/rogue/under/tomb)
"Lj" = (
/obj/structure/spider/stickyweb,
/obj/structure/spider/stickyweb{
	dir = 4
	},
/turf/open/floor/rogue/cobble,
/area/rogue/under/tomb)
"Lt" = (
/obj/structure/flora/roguegrass/water/reeds,
/obj/effect/waterfall,
/turf/open/water/river{
	dir = 4
	},
/area/rogue/under/tomb)
"LG" = (
/obj/structure/spider/stickyweb,
/obj/structure/spider/stickyweb,
/obj/machinery/light/rogue/wallfire/candle,
/turf/open/floor/rogue/cobble,
/area/rogue/under/tomb)
"MC" = (
/obj/structure/fluff/walldeco/vinez,
/turf/open/floor/rogue/cobblerock,
/area/rogue/under/tomb)
"NI" = (
/obj/structure/stairs/stone{
	dir = 1
	},
/obj/structure/fluff/walldeco/vinez,
/turf/open/floor/rogue/cobble,
/area/rogue/under/tomb)
"NT" = (
/obj/structure/flora/roguegrass/water,
/turf/open/water/river{
	dir = 4
	},
/area/rogue/under/tomb)
"NV" = (
/obj/structure/fluff/walldeco/vinez,
/turf/closed/mineral/rogue,
/area/rogue/under/tomb)
"NZ" = (
/obj/structure/fluff/walldeco/vinez,
/obj/structure/fluff/walldeco/vinez,
/turf/closed/wall/mineral/rogue/stone/moss,
/area/rogue/under/tomb)
"Oz" = (
/turf/closed/mineral/rogue,
/area/rogue/under/tomb)
"PH" = (
/obj/structure/flora/roguegrass/water/reeds,
/turf/open/water/river{
	dir = 4
	},
/area/rogue/under/tomb)
"PO" = (
/obj/structure/flora/roguegrass/water/reeds,
/obj/structure/flora/roguegrass/water/reeds,
/turf/open/water/river{
	dir = 8
	},
/area/rogue/under/tomb)
"Ra" = (
/obj/effect/spawner/lootdrop/roguetown/dungeon/spells,
/turf/open/floor/rogue/cobble,
/area/rogue/under/tomb)
"RL" = (
/obj/structure/spider/stickyweb,
/obj/structure/spider/stickyweb{
	dir = 8
	},
/turf/open/floor/rogue/cobble,
/area/rogue/under/tomb)
"Sb" = (
/obj/structure/fluff/walldeco/vinez,
/turf/closed/wall/mineral/rogue/stone/window/moss,
/area/rogue/under/tomb)
"Sz" = (
/obj/structure/spider/cocoon,
/turf/open/floor/rogue/cobblerock,
/area/rogue/under/tomb)
"SW" = (
/obj/effect/dungeon_directional_helper/north,
/turf/open/floor/rogue/cobblerock,
/area/rogue/under/tomb)
"TJ" = (
/turf/open/water/river,
/area/rogue/under/tomb)
"TM" = (
/obj/structure/mineral_door/bars,
/turf/open/floor/rogue/cobble,
/area/rogue/under/tomb)
"TT" = (
/turf/open/water/river{
	dir = 8
	},
/area/rogue/under/tomb)
"Ua" = (
/obj/effect/waterfall,
/turf/open/water/river,
/area/rogue/under/tomb)
"UL" = (
/turf/closed/wall/mineral/rogue/stone/window,
/area/rogue/under/tomb)
"UR" = (
/obj/structure/spider/stickyweb,
/obj/structure/spider/stickyweb{
	dir = 8
	},
/obj/structure/trap/fire,
/turf/open/floor/rogue/cobblerock,
/area/rogue/under/tomb)
"UZ" = (
/obj/structure/flora/roguegrass/water/reeds,
/turf/open/water/river{
	dir = 8
	},
/area/rogue/under/tomb)
"VF" = (
/obj/structure/spider/stickyweb,
/obj/structure/spider/stickyweb{
	dir = 1
	},
/obj/structure/trap/fire,
/turf/open/floor/rogue/cobble,
/area/rogue/under/tomb)
"VX" = (
/obj/structure/mineral_door/bars,
/turf/open/floor/rogue/cobblerock,
/area/rogue/under/tomb)
"WK" = (
/obj/structure/spider/stickyweb,
/obj/structure/spider/stickyweb,
/turf/open/floor/rogue/cobblerock,
/area/rogue/under/tomb)
"XE" = (
/obj/structure/stairs/stone,
/turf/open/floor/rogue/cobblerock,
/area/rogue/under/tomb)
"XH" = (
/obj/structure/mineral_door/bars,
/obj/structure/trap/saw_blades,
/turf/open/floor/rogue/cobblerock,
/area/rogue/under/tomb)
"XV" = (
/obj/structure/flora/roguegrass/water,
/obj/structure/flora/roguegrass/water/reeds,
/turf/open/water/river{
	dir = 8
	},
/area/rogue/under/tomb)
"Yg" = (
/obj/structure/mineral_door/bars,
/obj/machinery/light/rogue/wallfire/candle,
/turf/open/floor/rogue/cobble,
/area/rogue/under/tomb)
"YT" = (
/obj/structure/fluff/walldeco/vinez,
/obj/structure/fluff/walldeco/vinez,
/turf/closed/mineral/rogue,
/area/rogue/under/tomb)

(1,1,1) = {"
Oz
Oz
Oz
NV
qI
qI
ml
Oz
Kg
JR
mZ
mZ
ml
ml
Oz
Oz
Oz
ml
ml
Oz
"}
(2,1,1) = {"
Oz
Oz
NV
rQ
wE
mZ
Kg
Oz
Kg
mZ
mZ
Kg
xG
ml
mZ
Kg
Kg
mZ
Iu
ml
"}
(3,1,1) = {"
Oz
ml
ml
Oz
uS
HX
mZ
NV
Kg
mZ
Kg
Kg
xG
ml
mZ
Kg
Oz
qj
Ig
Oz
"}
(4,1,1) = {"
Oz
wE
qI
qI
Oz
wE
Ig
pS
mZ
Kg
mZ
mZ
mZ
VX
Kg
Oz
NV
zk
NV
Oz
"}
(5,1,1) = {"
Oz
nn
wE
NV
Oz
ml
ml
ml
mZ
Kg
mZ
mZ
Oz
Oz
ml
ml
eO
RL
NV
Oz
"}
(6,1,1) = {"
ml
Ig
mZ
Kg
Oz
TJ
Lt
Oz
wG
wG
TT
Oz
wt
mM
mM
yj
Kg
wE
wE
Oz
"}
(7,1,1) = {"
ml
Bj
eY
mZ
NV
NV
PH
cN
XV
qI
TT
mM
NT
Oz
UZ
qI
mZ
mZ
Kg
ml
"}
(8,1,1) = {"
ml
NV
NV
XH
qI
NT
tS
NV
XV
XV
TT
Oz
kc
kc
XV
YT
FX
NV
ml
qI
"}
(9,1,1) = {"
Kg
mZ
mZ
Kg
mZ
qH
rU
rU
sH
Ua
TJ
tS
kc
tS
qI
mZ
mZ
mZ
Kg
Kg
"}
(10,1,1) = {"
Kg
mZ
mZ
mZ
mZ
qH
Oz
TT
TT
NV
qI
wt
Oz
sH
sH
mZ
mZ
mZ
Kg
mZ
"}
(11,1,1) = {"
SW
mZ
Kg
Kg
Kg
qH
gR
mM
UZ
Oz
ml
wt
TJ
TJ
TJ
mZ
Kg
Kg
mZ
iT
"}
(12,1,1) = {"
Kg
Kg
Kg
mZ
mZ
qI
TT
ml
UZ
ue
qH
rU
vb
Oz
cN
Kg
Kg
Kg
mZ
mZ
"}
(13,1,1) = {"
ml
ml
NV
VX
ml
TJ
Ua
wt
sH
NT
Oz
NT
wG
pN
UZ
ml
VX
Oz
NV
NV
"}
(14,1,1) = {"
qI
NV
mZ
mZ
Oz
wG
Oz
tS
Oz
NT
TJ
NT
ml
PO
ml
NZ
mZ
mZ
JF
qI
"}
(15,1,1) = {"
NV
mZ
mZ
Kg
ml
XV
qH
qH
NT
wt
Oz
wt
mM
gR
gR
YT
sR
Ig
wE
qI
"}
(16,1,1) = {"
Oz
wE
Lj
NV
ml
qI
NV
Oz
Kg
Kg
mZ
mZ
Oz
qI
qI
ml
Oz
uh
Kg
ml
"}
(17,1,1) = {"
Oz
NV
VF
NV
Oz
Kg
FX
mZ
mZ
mZ
Kg
mZ
VX
Kg
Kg
qI
NV
ml
xw
Oz
"}
(18,1,1) = {"
ml
NV
Ig
UR
Ig
Kg
YT
EL
mZ
Kg
Kg
mZ
NV
CJ
mZ
qg
NV
ml
ml
ml
"}
(19,1,1) = {"
ml
kA
Ig
NV
Oz
Oz
qI
NI
mZ
mZ
Kg
Kg
Oz
wA
mZ
mZ
JM
qI
Oz
Oz
"}
(20,1,1) = {"
ml
ml
NV
NV
ml
ml
ml
NV
mZ
lf
mZ
Kg
Oz
Oz
qI
qI
qI
ml
Oz
Oz
"}

(1,1,2) = {"
ml
ml
qI
NV
NV
qI
ml
ml
Kg
mZ
mZ
mZ
ml
ml
qI
NV
Oz
Oz
NV
ml
"}
(2,1,2) = {"
ml
gh
wE
Ig
FX
mZ
mZ
Kg
mZ
mZ
mZ
Kg
lQ
XE
mZ
fG
mZ
Ig
Ig
qI
"}
(3,1,2) = {"
ml
bI
Sz
WK
YT
rD
Kg
ml
mZ
mZ
Kg
Kg
lQ
XE
mZ
qI
jC
WK
wE
qI
"}
(4,1,2) = {"
NV
mZ
WK
Jw
VX
mZ
Kg
mZ
mZ
mZ
Kg
Kg
Kg
Kg
WK
TM
bU
wE
Kg
ml
"}
(5,1,2) = {"
NV
FX
qI
Yg
Oz
Sb
NV
mZ
ml
Oz
oa
xd
qI
Oz
Sb
NV
VX
NV
zQ
NV
"}
(6,1,2) = {"
ml
mZ
Ig
bU
Oz
un
lQ
mZ
lQ
lQ
lQ
Kg
lQ
lQ
un
Oz
mZ
Ig
Ig
NV
"}
(7,1,2) = {"
qI
mZ
mZ
Ig
gh
Ct
lQ
lQ
lQ
Kg
lQ
lQ
lQ
Ct
lQ
kG
mZ
mZ
Ig
ml
"}
(8,1,2) = {"
Oz
mZ
qI
mZ
qI
lQ
lQ
Ct
lQ
lQ
lQ
mZ
lQ
lQ
lQ
Oz
mZ
ml
mZ
ml
"}
(9,1,2) = {"
mZ
mZ
Kg
Kg
Sb
lQ
lQ
lQ
un
lQ
lQ
lQ
lQ
lQ
mZ
mZ
mZ
Kg
Kg
mZ
"}
(10,1,2) = {"
mZ
Kg
Kg
Kg
Sb
Db
Kg
lQ
lQ
oF
jP
lQ
Kg
lQ
lQ
Oz
Ee
Kg
mZ
mZ
"}
(11,1,2) = {"
mZ
mZ
mZ
mZ
Oz
lQ
lQ
lQ
lQ
ed
Ra
lQ
lQ
lQ
lQ
cP
Kg
mZ
mZ
mZ
"}
(12,1,2) = {"
Kg
Kg
Kg
mZ
MC
Kg
lQ
mZ
lQ
lQ
lQ
un
lQ
Ct
lQ
NV
mZ
mZ
mZ
mZ
"}
(13,1,2) = {"
Oz
bU
ml
wE
ml
un
lQ
lQ
lQ
lQ
Ct
lQ
lQ
lQ
lQ
Oz
mZ
NV
Kg
NV
"}
(14,1,2) = {"
ml
WK
bU
bU
Oz
lQ
Ct
lQ
mZ
lQ
lQ
lQ
Kg
lQ
Kg
mZ
mZ
Kg
Kg
Oz
"}
(15,1,2) = {"
ml
mZ
Ig
Kg
qI
lQ
lQ
lQ
lQ
lQ
Kg
lQ
lQ
lQ
lQ
Oz
mZ
Kg
Kg
ml
"}
(16,1,2) = {"
NV
FX
Oz
zQ
qI
qI
NV
UL
ml
ml
rD
qI
qI
UL
UL
ml
VX
qI
Is
ml
"}
(17,1,2) = {"
NV
mZ
mZ
mZ
FX
mZ
mZ
Kg
mZ
mZ
mZ
Kg
Kg
Kg
Ig
VX
WK
mZ
Ig
Oz
"}
(18,1,2) = {"
qI
Kg
mZ
mZ
qI
rD
js
lQ
Kg
mZ
mZ
mZ
NV
bU
Ig
NV
LG
Kk
cB
Oz
"}
(19,1,2) = {"
ml
Kg
Kg
Kg
TM
Kg
js
lQ
Kg
Kg
mZ
mZ
WK
bU
Kg
yD
Kg
kU
xc
NV
"}
(20,1,2) = {"
ml
ml
ml
Oz
Oz
ml
ml
ml
Kg
mZ
mZ
mZ
ml
ml
ml
NV
NV
ml
qI
qI
"}
